0 0 0 0 0 0 0 0 0 0 0 0 0 0 0 0 0 0 0 0 0 0 0 0 0 0 0 0 0 0 0 0 0 0 0 0 0 0 0 0 0 0 0 0 0 0 0 0 0 0 0 0 0 0 0 0 0 0 0 0 0 0 0 0 0 0 0 0 0 0 0 0 0 0 0 0 0 0 0 0 0 0 0 0 0 0 0 0 0 0 0 0 0 0 0 0 0 0 0 0 
0 0 0 0 0 0 0 0 0 0 0 0 0 0 0 0 0 0 0 0 0 0 0 0 0 0 0 0 0 0 0 0 0 0 0 0 0 0 0 0 0 0 0 0 0 0 0 0 0 0 0 0 0 0 0 0 0 0 0 0 0 0 0 0 0 0 0 0 0 0 0 0 0 0 0 0 0 0 0 0 0 0 0 0 0 0 0 0 0 0 0 0 0 0 0 0 0 0 0 0 
0 0 0 0 0 0 0 0 0 0 0 0 0 0 0 0 0 0 0 0 0 0 0 0 0 0 0 0 0 0 0 0 0 0 0 0 0 0 0 0 0 0 0 0 0 0 0 0 0 0 0 0 0 0 0 0 0 0 0 0 0 0 0 0 0 0 0 0 0 0 0 0 0 0 0 0 0 0 0 0 0 0 0 0 0 0 0 0 0 0 0 0 0 0 0 0 0 0 0 0 
0 0 0 0 0 0 0 0 0 0 0 0 0 0 0 0 0 0 0 0 0 0 0 0 0 0 0 0 0 0 0 0 0 0 0 0 0 0 0 0 0 0 0 0 0 0 0 0 0 0 0 0 0 0 0 0 0 0 0 0 0 0 0 0 0 0 0 0 0 0 0 0 0 0 0 0 0 0 0 0 0 0 0 0 0 0 0 0 0 0 0 0 0 0 0 0 0 0 0 0 
0 0 0 0 0 0 0 0 0 0 0 0 0 0 0 0 62 5 5 5 5 5 5 5 5 5 5 5 5 5 5 5 5 5 5 5 5 5 5 5 5 5 5 5 5 5 5 5 5 5 5 5 5 5 5 5 5 5 5 5 5 5 5 5 5 0 0 0 0 0 0 0 0 0 0 0 0 0 0 0 0 0 0 0 0 0 0 0 0 0 0 0 0 0 0 0 0 0 0 0 
0 0 0 0 0 0 0 0 0 0 0 0 0 0 0 0 62 5 5 5 5 5 5 5 5 5 5 5 5 5 5 5 5 5 5 5 5 5 5 5 5 5 5 5 5 5 5 5 5 5 5 5 5 5 5 5 5 5 5 5 5 5 5 5 5 0 0 0 0 0 0 0 0 0 0 0 0 0 0 0 0 0 0 0 0 0 0 0 0 0 0 0 0 0 0 0 0 0 0 0 
0 0 0 0 0 0 0 0 0 0 0 0 0 0 0 0 52 77 5 5 5 5 5 5 5 5 5 5 5 5 5 5 5 5 5 5 5 5 5 5 5 5 5 5 5 5 5 5 5 5 5 5 5 5 5 5 5 5 5 5 5 5 5 5 5 0 0 0 0 0 0 0 0 0 0 0 0 0 0 0 0 0 0 0 0 0 0 0 0 0 0 0 0 0 0 0 0 0 0 0 
0 0 0 0 0 0 0 0 0 0 0 0 0 0 54 41 41 64 5 5 5 5 5 5 5 5 5 5 5 5 5 5 5 5 5 5 5 5 5 5 5 5 5 5 5 5 5 5 5 5 5 5 5 5 5 5 5 5 5 5 5 5 5 5 5 0 0 0 0 0 0 0 0 0 0 0 0 0 0 0 0 0 0 0 0 0 0 0 0 0 0 0 0 0 0 0 0 0 0 0 
0 0 0 0 0 0 0 0 0 0 0 0 0 0 43 40 40 63 5 5 5 5 5 5 5 5 5 5 5 5 5 5 5 5 5 5 5 5 5 5 5 5 5 5 5 5 5 5 5 5 5 5 5 5 5 5 5 5 5 5 5 5 5 5 5 0 0 0 0 0 0 0 0 0 0 0 0 0 0 0 0 0 0 0 0 0 0 0 0 0 0 0 0 0 0 0 0 0 0 0 
0 0 0 0 0 0 0 0 0 0 0 0 0 0 43 40 40 63 8 8 36 5 5 5 5 5 5 5 5 5 5 5 5 5 5 5 5 5 5 5 5 5 5 5 5 5 5 5 5 5 5 5 5 5 5 5 5 5 5 5 5 5 5 5 5 0 0 0 0 0 0 0 0 0 0 0 0 0 0 0 0 0 0 0 0 0 0 0 0 0 0 0 0 0 0 0 0 0 0 0 
0 0 0 0 0 0 0 0 0 0 0 0 0 0 43 39 39 57 1 1 37 35 5 5 5 5 5 5 5 5 5 5 5 5 5 5 5 33 8 36 5 5 5 5 5 5 5 5 5 5 5 5 5 5 5 5 5 5 5 5 5 5 5 5 5 0 0 0 0 0 0 0 0 0 0 0 0 0 0 0 0 0 0 0 0 0 0 0 0 0 0 0 0 0 0 0 0 0 0 0 
0 0 0 0 0 0 0 0 0 0 0 0 0 0 42 1 1 1 1 1 1 119 105 105 105 105 105 82 5 5 5 5 5 5 5 5 32 34 1 37 35 5 5 5 5 5 5 5 5 5 5 5 5 5 5 5 5 5 5 5 5 5 5 5 5 0 0 0 0 0 0 0 0 0 0 0 0 0 0 0 0 0 0 0 0 0 0 0 0 0 0 0 0 0 0 0 0 0 0 0 
0 0 0 0 0 0 0 0 0 0 0 0 0 0 42 1 1 1 1 1 30 28 5 5 5 5 5 82 5 5 5 5 5 5 5 5 17 1 1 1 14 5 5 5 5 5 5 5 5 5 5 5 5 5 5 5 5 5 5 5 5 5 5 5 5 0 0 0 0 0 0 0 0 0 0 0 0 0 0 0 0 0 0 0 0 0 0 0 0 0 0 0 0 0 0 0 0 0 0 0 
0 0 0 0 0 0 0 0 0 0 0 0 0 0 42 1 1 1 1 22 29 31 5 5 5 5 5 78 5 5 5 5 5 5 5 5 17 1 1 1 14 5 5 5 5 5 5 5 5 5 5 5 5 5 5 5 5 5 5 5 5 5 5 5 5 0 0 0 0 0 0 0 0 0 0 0 0 0 0 0 0 0 0 0 0 0 0 0 0 0 0 0 0 0 0 0 0 0 0 0 
0 0 0 0 0 0 0 0 0 0 0 0 0 0 52 38 38 38 59 28 5 5 5 5 5 5 5 78 5 5 5 5 5 5 5 5 24 26 1 30 28 5 5 5 5 5 5 5 5 5 5 5 5 5 5 5 5 5 5 5 5 5 5 5 5 0 0 0 0 0 0 0 0 0 0 0 0 0 0 0 0 0 0 0 0 0 0 0 0 0 0 0 0 0 0 0 0 0 0 0 
0 0 0 0 0 0 0 0 0 0 0 0 0 0 54 41 41 41 64 5 5 5 5 5 5 5 5 78 5 5 5 5 5 5 5 5 27 25 78 29 31 5 5 5 5 5 5 5 5 5 5 5 5 5 5 5 5 5 5 5 5 5 5 5 5 0 0 0 0 0 0 0 0 0 0 0 0 0 0 0 0 0 0 0 0 0 0 0 0 0 0 0 0 0 0 0 0 0 0 0 
0 0 0 0 0 0 0 0 0 0 0 0 0 0 43 40 40 40 63 5 5 5 5 5 5 5 5 78 5 5 5 5 5 5 5 5 5 5 78 5 5 5 5 5 5 5 5 5 5 5 5 5 5 5 5 5 5 5 5 5 5 5 5 5 5 0 0 0 0 0 0 0 0 0 0 0 0 0 0 0 0 0 0 0 0 0 0 0 0 0 0 0 0 0 0 0 0 0 0 0 
0 0 0 0 0 0 0 0 0 0 0 0 0 0 43 40 40 40 63 8 36 5 5 5 5 33 8 96 8 36 5 5 5 5 5 5 5 5 78 5 5 5 5 5 5 5 5 5 5 5 5 5 5 5 5 5 5 5 5 5 5 5 5 5 5 0 0 0 0 0 0 0 0 0 0 0 0 0 0 0 0 0 0 0 0 0 0 0 0 0 0 0 0 0 0 0 0 0 0 0 
0 0 0 0 0 0 0 0 0 0 0 0 0 0 43 40 40 73 57 1 34 35 5 5 32 34 1 1 1 37 35 5 5 5 5 5 5 5 78 5 5 5 5 5 5 5 5 5 5 5 5 5 5 5 5 5 5 5 5 5 5 5 5 5 5 0 0 0 0 0 0 0 0 0 0 0 0 0 0 0 0 0 0 0 0 0 0 0 0 0 0 0 0 0 0 0 0 0 0 0 
0 0 0 0 0 0 0 0 0 0 0 0 0 0 62 61 61 72 1 1 1 14 5 5 17 1 1 1 1 1 14 5 5 5 5 5 5 5 78 5 5 5 5 5 5 5 5 5 5 5 5 5 5 5 5 5 5 5 5 5 5 5 5 5 5 0 0 0 0 0 0 0 0 0 0 0 0 0 0 0 0 0 0 0 0 0 0 0 0 0 0 0 0 0 0 0 0 0 0 0 
0 0 0 0 0 0 0 0 0 0 0 0 0 0 62 8 8 21 1 1 1 119 101 101 101 1 1 1 1 1 101 101 101 111 111 111 101 101 101 101 101 101 101 5 5 5 5 5 5 5 5 5 5 5 5 5 5 5 5 5 5 5 5 5 5 0 0 0 0 0 0 0 0 0 0 0 0 0 0 0 0 0 0 0 0 0 0 0 0 0 0 0 0 0 0 0 0 0 0 0 
0 0 0 0 0 0 0 0 0 0 0 0 0 0 42 1 1 1 1 1 30 28 5 5 17 1 1 1 1 1 14 5 5 5 5 5 5 5 5 5 5 5 78 5 5 5 5 5 5 5 5 5 5 5 5 5 5 5 5 5 5 5 5 5 5 0 0 0 0 0 0 0 0 0 0 0 0 0 0 0 0 0 0 0 0 0 0 0 0 0 0 0 0 0 0 0 0 0 0 0 
0 0 0 0 0 0 0 0 0 0 0 0 0 0 42 1 22 11 11 11 29 31 5 5 24 26 1 1 1 30 28 5 5 5 5 5 5 5 5 5 5 5 78 5 5 5 5 5 5 5 5 5 5 5 5 5 5 5 5 5 5 5 5 5 5 0 0 0 0 0 0 0 0 0 0 0 0 0 0 0 0 0 0 0 0 0 0 0 0 0 0 0 0 0 0 0 0 0 0 0 
0 0 0 0 0 0 0 0 0 0 0 0 0 0 42 30 28 5 5 5 5 5 5 5 27 25 11 11 11 29 31 5 5 5 5 5 5 5 5 5 5 5 78 5 5 5 5 5 5 5 5 5 5 5 5 5 5 5 5 5 5 5 5 5 5 0 0 0 0 0 0 0 0 0 0 0 0 0 0 0 0 0 0 0 0 0 0 0 0 0 0 0 0 0 0 0 0 0 0 0 
0 0 0 0 0 0 0 0 0 0 0 0 0 0 62 29 31 5 5 5 5 5 5 5 5 5 5 5 5 5 5 5 5 5 5 5 5 5 5 5 5 5 78 5 5 5 5 5 5 5 5 5 5 5 5 5 5 5 5 5 5 5 5 5 5 0 0 0 0 0 0 0 0 0 0 0 0 0 0 0 0 0 0 0 0 0 0 0 0 0 0 0 0 0 0 0 0 0 0 0 
0 0 0 0 0 0 0 0 0 0 0 0 0 0 62 5 5 5 5 5 5 5 5 5 5 5 5 5 5 5 5 5 5 5 5 5 5 5 5 5 33 8 78 8 36 5 5 5 5 5 5 5 5 5 5 5 5 5 5 5 5 5 5 5 5 0 0 0 0 0 0 0 0 0 0 0 0 0 0 0 0 0 0 0 0 0 0 0 0 0 0 0 0 0 0 0 0 0 0 0 
0 0 0 0 0 0 0 41 41 41 41 55 0 0 62 5 5 5 5 5 5 5 5 5 5 5 5 5 5 5 5 5 5 5 5 5 5 5 5 32 34 1 1 1 37 35 5 5 5 5 5 5 5 5 5 5 5 5 5 5 5 5 5 5 5 0 0 0 0 0 0 0 0 0 0 0 0 0 0 0 0 0 0 0 0 0 0 0 0 0 0 0 0 0 0 0 0 0 0 0 
0 0 0 0 0 0 0 40 40 40 40 48 0 0 62 5 5 5 5 5 5 5 5 5 5 5 5 5 5 5 5 5 5 5 5 101 101 101 101 101 1 1 1 1 1 14 5 5 5 5 5 5 5 5 5 5 5 5 5 5 5 5 5 5 5 0 0 0 0 0 0 0 0 0 0 0 0 0 0 0 0 0 0 0 0 0 0 0 0 0 0 0 0 0 0 0 0 0 0 0 
0 0 0 0 0 0 0 40 40 40 40 48 0 0 62 5 5 5 5 5 5 5 5 5 5 5 5 5 5 5 5 5 5 5 5 78 5 5 5 24 26 1 1 1 30 28 5 5 5 5 5 5 5 5 5 5 5 5 5 5 5 5 5 5 5 0 0 0 0 0 0 0 0 0 0 0 0 0 0 0 0 0 0 0 0 0 0 0 0 0 0 0 0 0 0 0 0 0 0 0 
0 0 0 0 0 0 0 40 40 40 40 48 0 0 62 5 5 5 5 5 5 5 5 5 5 5 5 5 5 5 5 5 5 5 5 78 5 5 5 27 25 11 11 11 29 31 5 5 5 5 5 5 5 5 5 5 5 5 5 5 5 5 5 5 5 0 0 0 0 0 0 0 0 0 0 0 0 0 0 0 0 0 0 0 0 0 0 0 0 0 0 0 0 0 0 0 0 0 0 0 
0 0 0 0 0 0 0 61 61 61 61 65 0 0 62 5 5 5 5 5 5 5 5 5 5 5 5 5 5 5 5 5 5 5 5 78 5 5 5 5 5 5 5 5 5 5 5 5 5 5 5 5 5 5 5 5 5 5 5 5 5 5 5 5 5 0 0 0 0 0 0 0 0 0 0 0 0 0 0 0 0 0 0 0 0 0 0 0 0 0 0 0 0 0 0 0 0 0 0 0 
0 0 0 0 0 0 0 60 60 77 5 67 55 0 62 5 5 5 5 5 5 5 5 5 5 5 5 5 5 5 5 5 5 5 5 78 5 5 5 5 5 5 5 5 33 36 5 5 5 5 5 5 5 5 5 5 5 5 5 5 5 5 5 5 5 0 0 0 0 0 0 0 0 0 0 0 0 0 0 0 0 0 0 0 0 0 0 0 0 0 0 0 0 0 0 0 0 0 0 0 
0 0 0 0 0 0 0 0 0 62 5 66 48 0 62 5 5 5 5 5 5 5 5 5 5 5 5 5 5 5 5 5 5 5 33 78 36 5 5 5 5 5 5 32 34 37 35 5 5 5 5 5 5 5 5 5 5 5 5 5 5 5 5 5 5 0 0 0 0 0 0 0 0 0 0 0 0 0 0 0 0 0 0 0 0 0 0 0 0 0 0 0 0 0 0 0 0 0 0 0 
0 0 0 0 0 0 0 0 0 62 5 66 48 0 62 5 5 5 5 5 5 5 5 5 5 5 5 5 5 5 5 5 5 32 34 1 37 35 5 5 5 5 5 17 1 1 20 8 36 5 5 5 5 5 5 5 5 5 5 5 5 5 5 5 5 0 0 0 0 0 0 0 0 0 0 0 0 0 0 0 0 0 0 0 0 0 0 0 0 0 0 0 0 0 0 0 0 0 0 0 
0 0 0 0 0 0 0 0 0 62 5 66 48 0 62 5 5 5 5 5 5 5 5 5 5 5 5 5 78 101 101 101 101 101 1 1 1 101 101 101 101 101 101 101 1 1 1 1 37 35 5 5 5 5 5 5 5 5 5 5 5 5 5 5 5 1 1 1 1 1 1 1 1 1 1 1 1 1 1 1 1 1 1 1 1 1 1 1 1 1 1 1 1 1 1 1 1 1 1 1 
0 0 0 0 0 0 0 0 0 62 5 74 67 55 52 77 5 5 5 5 5 5 5 5 5 5 5 5 78 5 5 5 5 24 26 1 30 28 5 5 5 5 5 24 26 1 1 1 30 28 5 5 5 5 5 5 5 5 5 5 5 5 5 5 5 1 1 1 1 1 1 1 1 1 1 1 1 1 1 1 1 1 1 1 1 1 1 1 1 1 1 1 1 1 1 1 1 1 1 1 
0 0 0 0 0 0 0 0 0 62 5 5 66 48 0 62 5 5 5 5 5 5 5 5 5 5 5 33 78 36 5 5 5 27 25 11 29 31 5 5 5 5 5 27 25 11 78 78 29 5 5 5 5 5 5 5 5 5 5 5 5 5 5 5 5 1 1 1 1 1 1 1 1 1 1 1 1 1 1 1 1 1 1 1 1 1 1 1 1 1 1 1 1 1 1 1 1 1 1 1 
0 0 0 0 47 0 0 0 0 62 5 5 66 48 0 62 5 5 5 5 5 5 5 5 5 5 32 34 1 37 35 5 5 5 5 5 5 5 5 5 5 5 5 5 5 5 78 78 5 5 5 5 5 5 5 5 5 5 5 5 5 5 5 5 5 1 1 1 1 1 1 1 1 1 1 1 1 1 1 1 1 1 1 1 1 1 1 1 1 1 1 1 1 1 1 1 1 1 1 1 
0 0 42 1 47 0 0 0 0 62 5 5 66 48 0 62 5 5 5 5 5 5 5 5 5 33 21 1 1 37 14 5 5 5 5 5 5 5 5 5 5 5 5 5 5 5 78 78 5 5 5 5 5 5 5 5 5 33 8 36 5 5 5 5 5 1 1 1 1 1 1 1 1 1 1 1 1 1 1 1 1 1 1 1 1 1 1 1 1 1 1 1 1 1 1 1 1 1 1 1 
0 0 42 1 47 0 0 0 0 62 5 5 74 67 41 64 5 5 5 5 5 5 5 5 32 34 1 1 1 1 14 5 5 5 5 5 5 5 5 5 5 5 5 5 5 5 78 78 5 5 5 5 5 5 5 5 32 37 1 37 35 5 5 17 1 1 1 1 1 1 1 1 1 1 1 1 1 1 1 1 1 1 1 1 1 1 1 1 1 1 1 1 1 1 1 1 1 1 1 1 
0 54 45 1 47 0 0 0 0 62 5 5 5 66 40 63 5 5 5 5 5 5 5 5 24 26 1 1 1 30 28 5 5 5 5 5 5 5 5 5 5 5 5 5 5 5 78 78 101 101 101 101 101 101 101 101 101 1 1 1 20 36 5 17 1 1 1 1 1 1 1 1 1 1 1 1 1 1 1 1 1 1 1 1 1 1 1 1 1 1 1 1 1 1 1 1 1 1 1 1 
0 43 44 1 47 0 0 0 0 52 77 5 5 66 40 63 5 5 5 5 5 5 5 5 5 25 11 11 11 29 31 5 5 5 5 5 5 5 5 5 5 5 5 5 5 5 78 78 101 101 101 101 101 101 101 101 101 1 1 1 1 37 35 17 1 1 1 1 1 1 1 1 1 1 1 1 1 1 1 1 1 1 1 1 1 1 1 1 1 1 1 1 1 1 1 1 1 1 1 1 
0 43 44 1 47 0 0 0 0 0 62 5 5 66 40 63 5 5 5 5 5 5 5 5 5 5 5 5 5 5 5 5 5 5 5 5 5 5 5 5 5 5 5 5 5 5 78 78 5 5 5 5 5 5 5 5 24 26 1 1 1 1 20 21 1 1 1 1 1 1 1 1 1 1 1 1 1 1 1 1 1 1 1 1 1 1 1 1 1 1 1 1 1 1 1 1 1 1 1 1 
0 43 57 1 47 0 0 0 0 0 62 5 5 74 61 75 5 5 5 5 5 5 5 5 5 5 5 5 5 5 5 5 5 5 5 5 5 5 5 5 5 5 5 5 5 5 78 78 5 5 5 5 5 5 5 5 27 25 11 23 1 1 1 1 1 1 1 1 1 1 1 1 1 1 1 1 1 1 1 1 1 1 1 1 1 1 1 1 1 1 1 1 1 1 1 1 1 1 1 1 
0 42 1 1 50 55 0 0 0 0 62 5 5 76 60 77 5 5 5 5 5 5 5 5 5 5 5 5 5 5 5 5 5 5 5 5 5 5 5 5 5 5 5 5 5 5 78 78 5 5 5 5 5 5 5 5 5 5 5 24 26 1 1 1 1 1 1 1 1 1 1 1 1 1 1 1 1 1 1 1 1 1 1 1 1 1 1 1 1 1 1 1 1 1 1 1 1 1 1 1 
54 46 1 1 49 48 0 0 0 0 62 5 5 65 0 62 5 5 5 5 5 5 5 5 5 5 5 5 5 5 5 5 5 5 5 5 5 5 5 5 5 5 5 5 5 5 78 78 5 5 5 5 5 5 5 5 5 5 5 27 25 11 23 1 1 1 1 1 1 1 1 1 1 1 1 1 1 1 1 1 1 1 1 1 1 1 1 1 1 1 1 1 1 1 1 1 1 1 1 1 
43 44 1 1 49 48 0 0 0 0 62 5 5 65 0 62 8 8 8 8 8 8 8 8 36 5 5 5 5 5 5 33 8 8 8 8 36 5 5 5 5 5 5 5 5 5 78 78 5 5 5 5 5 5 5 5 5 5 5 5 5 33 21 1 1 1 1 1 1 1 1 1 1 1 1 1 1 1 1 1 1 1 1 1 1 1 1 1 1 1 1 1 1 1 1 1 1 1 1 1 
43 44 1 1 56 48 0 0 0 0 62 5 5 65 54 45 1 1 1 1 1 1 1 1 37 35 5 5 5 5 32 34 1 1 1 1 37 35 5 5 5 5 5 5 5 5 78 78 5 5 5 5 5 5 5 5 5 5 5 5 32 34 1 1 1 1 1 1 1 1 1 1 1 1 1 1 1 1 1 1 1 1 1 1 1 1 1 1 1 1 1 1 1 1 1 1 1 1 1 1 
43 57 1 1 1 47 0 0 0 0 62 5 5 65 43 44 1 1 1 1 1 1 1 1 1 101 101 101 101 101 101 1 1 1 1 1 1 101 101 101 101 101 101 101 101 101 101 101 5 5 5 5 5 5 5 5 5 5 5 5 17 1 1 1 1 1 5 5 5 5 5 5 5 5 5 5 5 5 5 5 5 5 5 5 5 5 5 5 5 5 5 5 5 5 5 5 5 5 5 5 
42 1 1 1 58 53 0 0 0 0 62 5 5 65 43 44 1 1 1 1 1 1 1 1 1 101 101 101 101 101 101 1 1 1 1 1 1 101 101 101 101 101 101 101 101 101 101 101 5 5 5 5 5 5 5 5 5 5 5 5 24 26 1 1 1 1 5 5 5 5 5 5 5 5 5 5 5 5 5 5 5 5 5 5 5 5 5 5 5 5 5 5 5 5 5 5 5 5 5 5 
42 1 1 1 47 0 0 0 0 0 62 5 5 65 43 57 1 1 1 1 1 1 1 1 1 14 5 5 5 5 24 26 1 1 1 1 30 28 5 5 5 5 5 5 5 5 5 5 5 5 5 5 5 5 5 5 5 5 5 5 27 25 23 1 1 1 1 5 5 5 5 5 5 5 5 5 5 5 5 5 5 5 5 5 5 5 5 5 5 5 5 5 5 5 5 5 5 5 5 5 
42 1 1 1 47 0 0 0 0 0 62 5 5 65 42 1 1 1 1 1 1 1 1 1 1 28 5 5 5 5 27 25 11 78 78 11 29 31 5 5 5 5 5 5 5 5 5 5 5 5 5 5 5 5 5 5 5 5 5 5 5 5 24 26 1 1 1 1 5 5 5 5 5 5 5 5 5 5 5 5 5 5 5 5 5 5 5 5 5 5 5 5 5 5 5 5 5 5 5 5 
42 1 1 1 47 0 0 0 0 0 62 5 5 65 52 38 38 38 38 59 1 1 1 22 29 5 5 5 5 5 5 5 5 78 78 5 5 5 5 5 5 5 5 5 5 5 5 5 5 5 5 5 5 5 5 5 5 5 5 5 5 5 27 25 23 1 1 1 1 5 5 5 5 5 5 5 5 5 5 5 5 5 5 5 5 5 5 5 5 5 5 5 5 5 5 5 5 5 5 5 
42 1 1 58 53 0 0 0 0 0 62 5 5 65 0 54 41 41 41 45 1 1 1 14 5 5 5 5 5 5 5 5 5 78 78 5 5 5 5 5 5 5 5 5 5 5 5 5 5 5 5 5 5 5 5 5 5 5 5 5 5 5 5 5 17 1 1 1 1 5 5 5 5 5 5 5 5 5 5 5 5 5 5 5 5 5 5 5 5 5 5 5 5 5 5 5 5 5 5 5 
52 59 1 47 0 0 0 0 0 0 62 5 5 65 0 43 40 40 40 44 1 1 1 20 8 8 8 36 5 5 5 5 5 78 78 5 5 5 5 5 5 5 5 5 5 5 5 5 5 5 5 5 5 5 5 5 5 5 5 5 5 5 5 5 24 26 1 1 1 5 5 5 5 5 5 5 5 5 5 5 5 5 5 5 5 5 5 5 5 5 5 5 5 5 5 5 5 5 5 5 
0 42 1 47 0 0 0 0 0 0 62 5 5 65 0 43 40 40 40 44 1 1 1 1 1 1 1 37 35 5 5 5 5 78 78 101 101 101 101 101 101 101 101 101 101 5 5 5 5 5 5 5 5 5 5 5 5 5 5 5 5 5 5 5 27 25 23 1 1 5 5 5 5 5 5 5 5 5 5 5 5 5 5 5 5 5 5 5 5 5 5 5 5 5 5 5 5 5 5 5 
0 42 1 50 55 0 0 0 0 0 62 5 5 65 0 43 39 39 39 57 1 1 1 1 1 1 1 58 68 60 60 77 5 78 78 101 101 101 101 101 101 101 101 101 101 5 5 5 5 5 5 5 5 5 5 5 5 5 33 8 8 8 36 5 5 5 17 1 1 5 5 5 5 5 5 5 5 5 5 5 5 5 5 5 5 5 5 5 5 5 5 5 5 5 5 5 5 5 5 5 
0 42 1 49 48 0 0 0 0 0 62 5 5 65 0 42 1 1 1 1 1 1 1 1 1 1 1 47 0 0 0 62 5 5 5 5 5 5 5 5 5 5 5 78 78 5 5 5 5 5 5 5 5 5 5 5 5 32 34 1 1 1 37 35 5 5 17 1 1 5 5 5 5 5 5 5 5 5 5 5 5 5 5 5 5 5 5 5 5 5 5 5 5 5 5 5 5 5 5 5 
0 42 1 49 48 54 41 41 41 41 64 5 5 67 41 45 1 1 1 58 38 38 38 59 1 1 1 47 0 0 0 52 60 60 60 77 36 5 5 5 5 5 5 78 78 5 5 5 5 5 5 5 5 5 5 5 33 21 1 1 1 1 1 20 8 8 21 1 1 1 1 1 1 1 1 1 1 1 1 1 1 1 5 5 5 5 5 5 5 5 5 5 5 5 5 5 5 5 5 5 
0 42 1 56 48 43 40 40 40 40 63 5 5 66 40 44 1 1 1 47 0 0 0 52 38 38 38 53 0 0 0 0 0 0 0 42 34 35 5 5 5 5 5 78 78 5 5 5 5 5 5 5 5 5 5 32 34 1 1 1 1 1 1 1 1 1 1 1 1 1 1 1 1 1 1 1 1 1 1 1 1 1 5 5 5 5 5 5 5 5 5 5 5 5 5 5 5 5 5 5 
0 42 1 1 47 43 40 40 40 40 63 5 5 66 40 44 1 1 1 50 41 41 41 41 41 41 41 41 55 0 0 0 0 0 0 42 1 14 5 5 5 5 5 78 78 5 5 5 5 5 5 5 5 5 33 21 1 1 1 1 1 1 1 1 1 1 1 1 1 1 1 1 1 1 1 1 1 1 1 1 1 1 5 5 5 5 5 5 5 5 5 5 5 5 5 5 5 5 5 5 
0 52 59 1 50 46 40 40 40 40 63 5 5 66 73 57 1 1 1 49 40 40 40 40 40 40 40 40 48 0 0 0 0 0 0 42 1 14 5 5 5 5 5 78 78 5 5 5 5 5 5 5 5 32 34 1 1 1 1 1 1 1 1 1 1 1 1 1 1 1 1 1 1 1 1 1 1 1 1 1 1 1 5 5 5 5 5 5 5 5 5 5 5 5 5 5 5 5 5 5 
0 0 43 1 49 63 61 61 61 61 75 5 5 74 72 1 1 1 1 49 40 40 40 40 40 40 40 40 48 0 0 0 0 54 41 45 1 14 5 5 5 5 5 78 78 5 5 5 5 5 5 5 5 17 1 1 1 1 1 1 1 1 1 1 1 1 1 1 1 1 1 1 1 1 1 1 1 1 1 1 1 1 5 5 5 5 5 5 5 5 5 5 5 5 5 5 5 5 5 5 
0 0 43 1 49 63 5 5 5 5 5 5 5 5 17 1 1 1 1 56 39 39 39 39 39 39 39 39 48 0 0 0 0 43 40 44 1 14 5 5 5 5 5 78 78 5 5 5 5 5 5 5 5 17 1 1 1 1 1 1 1 14 5 5 5 17 1 1 1 1 1 1 1 1 1 1 1 1 1 1 1 1 5 5 5 5 5 5 5 5 5 5 5 5 5 5 5 5 5 5 
0 0 43 1 56 63 5 5 5 5 5 5 5 5 17 1 1 1 1 1 1 1 1 1 1 1 1 1 47 0 0 0 0 43 40 44 30 28 5 5 5 5 5 78 78 101 101 101 101 101 101 101 101 101 1 1 1 1 1 1 1 14 5 5 5 17 1 1 1 1 1 1 1 1 1 1 1 1 1 1 1 1 5 5 5 5 5 5 5 5 5 5 5 5 5 5 5 5 5 5 
0 0 62 1 1 14 5 5 5 5 5 5 5 5 17 1 1 1 58 38 38 38 38 38 38 59 1 1 47 0 0 0 0 43 40 63 29 31 5 5 5 5 5 78 78 101 101 101 101 101 101 101 101 101 1 1 1 1 1 1 1 119 101 101 101 101 1 1 1 1 1 1 1 1 1 1 1 1 1 1 1 1 5 5 5 5 5 5 5 5 5 5 5 5 5 5 5 5 5 5 
0 0 62 1 1 14 5 5 5 5 5 5 5 5 17 1 1 1 47 0 0 0 0 0 0 52 38 38 53 0 0 0 0 62 61 75 5 5 5 5 5 5 5 78 78 5 5 5 5 5 5 5 5 24 26 1 1 1 1 1 1 119 101 101 101 101 1 1 1 1 1 1 1 1 1 1 1 5 5 5 5 5 5 5 5 5 5 5 5 5 5 5 5 5 5 5 5 5 5 65 
0 0 62 1 30 28 5 33 36 5 5 33 8 8 21 1 1 1 47 0 0 0 0 0 0 0 0 0 0 0 54 41 41 64 5 5 5 5 5 5 5 5 5 78 78 5 5 5 5 5 5 5 5 27 25 11 11 23 1 1 1 14 5 5 5 24 26 1 1 1 1 1 1 1 1 1 1 5 5 5 5 5 5 5 5 5 5 5 5 5 5 5 5 5 5 5 5 5 5 65 
0 0 62 78 29 5 32 34 37 35 32 34 1 1 1 1 1 1 47 0 0 0 0 0 0 0 0 0 0 0 43 40 40 63 5 5 5 5 5 5 5 5 5 78 78 5 5 5 5 5 5 5 5 5 5 5 5 24 26 1 30 28 5 5 5 27 25 11 11 23 1 1 1 1 1 1 1 5 5 5 5 5 5 5 5 5 5 5 5 5 5 5 5 5 5 5 5 5 5 65 
0 0 62 78 101 101 101 1 1 119 105 1 1 1 1 1 1 1 47 0 0 0 0 0 0 0 0 0 0 0 43 40 40 63 5 5 5 5 5 5 5 5 5 78 78 5 5 5 5 5 5 5 5 5 5 5 5 27 25 11 29 31 5 5 5 5 5 5 5 17 1 1 1 1 1 1 1 5 5 5 5 5 5 5 5 5 5 5 5 5 5 5 5 5 5 5 5 5 5 65 
0 0 62 5 5 5 76 38 38 77 17 1 1 1 1 1 1 1 47 0 0 0 0 0 0 0 0 0 0 0 43 40 40 63 5 5 5 5 5 5 5 5 5 78 78 5 5 5 5 5 5 5 5 5 5 5 5 5 5 5 5 5 5 5 5 5 5 5 5 24 26 1 1 1 1 1 1 5 5 5 5 5 5 5 5 5 5 5 5 5 5 5 5 5 5 5 5 5 5 65 
0 0 52 77 5 5 65 0 0 42 17 1 1 1 1 1 1 1 47 0 0 0 0 0 0 0 0 0 0 0 62 61 61 75 5 5 5 5 5 5 5 5 5 78 78 5 5 5 5 5 5 5 5 5 5 5 5 5 5 5 5 5 5 5 5 5 5 5 5 27 25 11 23 1 1 1 1 5 5 5 5 5 5 5 5 5 5 5 5 5 5 5 5 5 5 5 5 5 5 65 
0 0 0 62 5 5 65 0 0 52 69 38 59 1 1 1 1 1 50 55 0 0 0 0 0 0 0 0 0 0 52 77 5 5 5 5 5 5 5 5 5 5 5 78 78 5 5 5 5 5 5 5 5 5 5 5 5 5 5 5 5 5 5 5 5 5 5 5 5 5 5 5 17 1 22 11 11 5 5 5 5 5 5 5 5 5 5 5 5 5 5 5 5 5 5 5 5 5 5 65 
0 0 0 52 60 60 53 0 0 0 0 0 52 38 38 59 1 1 49 48 0 0 0 0 0 0 0 0 0 0 0 52 77 5 5 5 5 5 5 5 5 5 5 78 78 5 5 5 5 5 5 5 5 5 5 5 5 5 5 5 5 5 5 5 5 5 5 5 5 5 5 5 17 1 14 5 5 5 5 5 5 5 5 5 5 5 5 5 5 5 5 5 5 5 5 5 5 5 5 65 
0 0 0 0 0 0 0 0 0 0 0 0 0 0 0 42 1 1 49 48 0 0 0 0 0 0 0 0 0 0 0 0 62 5 5 5 5 5 5 5 5 5 5 78 78 5 5 5 5 5 5 5 5 33 36 5 5 5 5 5 5 5 5 5 5 5 5 5 5 5 5 33 21 1 14 5 5 5 5 5 5 5 5 5 5 5 5 5 5 5 5 5 5 5 5 5 5 5 5 65 
0 54 41 41 41 41 41 41 41 41 41 41 41 41 41 45 1 1 56 51 41 41 41 41 41 41 41 41 41 41 55 0 62 5 5 5 5 5 5 5 5 5 33 96 96 36 5 5 5 5 5 5 32 34 37 35 5 5 5 5 5 5 5 5 5 5 5 5 5 5 32 34 1 1 14 5 5 5 5 5 5 5 5 5 5 5 5 5 5 5 5 5 5 5 5 5 5 5 5 65 
0 43 40 40 40 40 40 40 40 40 40 40 40 40 40 44 1 1 1 49 40 40 40 40 40 40 40 40 40 40 48 0 62 5 5 5 5 5 5 5 5 32 34 1 1 37 35 5 5 5 5 5 17 1 1 14 5 5 5 5 5 5 5 5 5 5 5 5 5 5 24 26 1 1 14 5 5 5 5 5 5 5 5 5 5 5 5 5 5 5 5 5 5 5 5 5 5 5 5 65 
0 43 40 40 40 40 40 40 40 40 40 58 38 59 40 44 1 1 1 49 40 40 40 40 40 40 40 40 40 40 51 41 64 5 5 5 5 5 33 8 8 21 1 1 1 1 14 5 5 5 5 33 21 1 1 20 8 8 8 36 5 5 5 5 5 5 5 5 5 5 27 25 23 1 14 5 5 5 5 5 5 5 5 5 5 5 5 5 5 5 5 5 5 5 5 5 5 5 5 65 
0 43 40 40 40 40 40 40 40 40 40 67 41 64 39 57 1 1 1 56 39 39 39 71 40 40 73 39 39 39 49 40 63 5 5 5 5 32 34 1 1 1 1 1 1 1 14 5 5 5 32 34 1 1 1 1 1 1 1 37 35 5 5 5 5 5 5 5 5 5 5 5 17 1 20 8 8 8 36 5 5 5 5 5 5 5 5 5 5 5 5 5 5 5 5 5 5 5 5 65 
54 46 61 61 61 61 61 61 61 61 61 66 40 44 1 1 1 1 1 1 1 1 1 70 61 61 72 1 1 1 49 40 63 8 36 5 5 17 1 1 1 1 1 1 1 1 20 8 8 8 21 1 1 1 1 1 1 1 1 1 14 5 5 5 5 5 5 5 5 33 8 8 21 1 1 1 1 1 37 35 5 5 5 5 5 5 5 5 5 5 5 5 5 5 5 5 5 5 5 65 
43 63 5 5 5 5 5 5 5 5 5 66 40 44 1 1 1 1 1 1 1 1 1 14 5 5 17 1 1 1 56 39 57 1 37 35 5 17 1 1 1 1 1 1 1 1 1 1 1 1 1 1 1 1 1 1 1 1 1 1 20 36 5 5 5 5 5 5 32 34 1 1 1 1 1 1 1 1 1 20 8 8 8 8 8 8 36 5 5 5 5 5 5 5 5 5 5 5 5 65 
43 63 5 5 5 5 5 5 5 5 5 66 40 63 23 1 1 1 1 1 1 1 1 122 111 111 111 1 1 1 1 1 1 1 1 20 8 21 1 1 1 1 1 1 1 1 1 1 1 1 1 1 1 1 1 1 1 1 1 1 1 37 35 5 5 5 5 5 17 1 1 1 1 1 1 1 1 1 1 1 1 1 1 1 1 1 37 35 5 5 5 5 5 5 5 5 5 5 5 65 
43 63 5 5 76 60 77 5 5 5 5 74 61 75 17 1 1 1 1 1 1 1 1 121 107 107 107 1 1 1 1 1 1 1 1 1 1 1 1 1 1 1 1 1 1 1 1 22 11 11 11 11 11 23 1 1 1 1 1 1 1 1 119 101 101 101 101 101 101 1 1 1 1 1 1 1 1 1 1 1 1 1 1 1 1 1 1 20 8 36 5 5 5 5 5 5 5 5 5 65 
62 75 5 5 67 41 64 5 5 5 31 33 8 8 21 1 1 1 1 1 1 1 1 14 5 5 17 1 1 1 1 1 22 11 11 11 11 23 1 1 1 1 1 1 1 1 30 28 5 5 5 5 5 17 1 1 1 1 1 1 1 1 119 101 101 101 101 101 101 1 1 1 1 1 1 1 1 1 1 1 1 1 1 1 1 1 1 1 1 37 35 5 5 5 5 5 5 5 5 65 
62 5 5 5 66 40 63 5 5 5 32 1 1 1 1 1 1 1 1 1 1 1 1 14 5 5 24 26 1 1 1 30 28 5 5 5 5 17 1 1 1 1 22 11 11 11 29 31 5 5 5 5 5 24 26 1 1 1 1 1 1 30 28 5 5 5 5 5 24 1 1 1 1 1 1 1 1 1 22 11 11 11 11 11 11 23 1 1 1 1 14 5 5 5 5 5 5 5 5 65 
62 5 5 5 66 40 63 5 5 5 24 26 1 1 1 1 1 1 1 1 1 1 1 14 5 5 27 25 11 11 11 29 31 5 5 5 5 24 26 1 1 30 28 5 5 5 5 5 5 5 5 5 5 27 25 11 11 11 11 11 11 29 31 5 5 5 5 5 27 25 11 23 1 1 1 1 1 1 14 5 5 33 8 8 8 21 1 1 1 1 20 8 36 5 5 5 5 5 5 65 
52 77 5 5 66 40 73 5 76 77 27 25 11 78 78 11 11 11 11 23 1 1 1 14 5 5 5 5 5 5 5 5 5 5 5 5 5 27 25 78 78 29 31 5 5 5 5 5 5 5 5 5 5 5 5 5 5 5 5 5 5 5 5 5 5 5 5 5 5 5 5 17 1 1 1 1 1 1 14 5 32 34 1 1 1 1 1 1 1 1 1 1 37 35 5 5 5 5 5 65 
0 62 5 5 74 61 75 5 67 64 5 5 33 98 99 8 36 5 5 17 1 1 1 14 5 5 5 5 5 5 5 5 5 5 5 5 5 5 5 78 78 5 5 5 5 5 5 5 5 76 60 60 77 5 5 5 5 5 5 5 5 5 5 5 5 5 5 5 5 5 5 24 26 1 1 1 1 30 28 5 24 26 1 1 1 1 1 1 1 1 1 1 1 20 8 36 5 5 5 65 
0 62 5 5 5 5 5 5 66 63 5 32 34 1 1 1 37 35 5 24 26 1 30 28 5 5 5 5 5 5 5 5 5 5 5 5 5 5 5 78 78 5 5 5 5 5 5 5 5 65 0 0 62 5 5 5 5 5 5 5 5 5 5 5 5 5 5 5 5 5 5 27 25 11 11 11 11 29 31 5 27 25 11 11 23 1 1 1 1 1 1 1 1 1 1 37 35 5 5 65 
0 52 60 77 8 8 8 8 66 63 8 21 1 1 37 1 1 14 5 27 25 11 29 31 5 5 5 5 5 5 5 5 5 5 33 8 8 8 8 96 96 8 36 5 5 5 5 5 5 65 0 0 52 77 5 5 5 5 5 5 5 5 5 5 5 5 5 5 5 5 5 5 5 5 5 33 8 8 8 8 8 8 8 8 21 1 1 1 1 1 1 1 1 1 1 1 20 8 8 65 
0 0 0 42 1 1 1 1 56 57 1 1 1 1 1 1 1 14 5 5 5 5 5 5 5 5 5 5 5 5 5 5 5 32 1 1 1 1 1 1 1 1 37 35 5 5 5 5 5 65 0 0 0 52 60 60 60 60 77 5 5 5 5 5 5 5 5 5 5 5 5 5 5 5 32 34 1 1 1 1 1 1 1 1 1 1 1 1 1 1 1 1 1 1 1 1 1 1 1 47 
0 0 0 42 1 1 1 1 1 1 1 1 1 1 1 1 30 28 5 5 5 76 60 60 77 5 5 5 5 33 8 8 8 21 1 1 1 1 1 1 1 1 1 14 5 5 5 76 60 53 0 0 0 0 0 0 0 0 62 5 5 5 5 5 5 5 5 5 5 5 5 5 5 33 21 1 1 1 1 1 1 1 1 1 1 1 1 1 1 1 1 1 1 1 1 1 1 1 1 47 
54 41 41 45 1 1 1 1 1 1 1 1 1 1 1 22 29 31 5 5 5 65 0 0 52 77 5 5 32 34 1 1 1 1 1 1 1 1 1 1 1 1 30 28 76 60 60 53 0 0 0 0 0 0 0 0 0 0 62 5 5 5 5 5 5 5 5 5 5 5 5 5 32 34 1 1 1 1 1 1 1 1 1 1 1 1 1 22 23 1 1 1 1 1 1 1 1 1 22 65 
43 40 40 63 23 1 1 1 1 1 1 1 1 1 30 28 5 5 5 5 5 65 0 0 0 52 77 5 24 26 1 1 1 1 1 1 1 1 1 1 22 11 29 31 65 0 0 0 0 0 0 0 0 0 0 0 0 0 0 60 77 5 5 5 5 5 5 5 5 5 5 5 24 26 1 1 1 1 1 1 1 1 1 1 1 1 30 28 17 1 1 1 22 11 11 23 1 1 14 65 
43 40 40 63 17 1 1 1 1 1 1 1 1 22 29 31 5 5 5 76 60 53 0 0 0 0 62 5 27 25 23 1 1 1 1 1 1 1 1 1 14 76 60 60 53 0 0 0 0 0 0 0 0 0 0 0 0 0 0 0 62 5 5 5 5 5 5 5 5 5 5 5 27 25 11 11 11 11 23 1 1 1 22 11 11 11 29 31 24 26 1 30 28 5 5 17 1 1 14 65 
43 40 40 63 17 1 1 1 1 1 1 1 1 14 5 76 60 77 5 65 0 0 0 0 0 0 52 60 77 8 21 1 1 1 1 1 1 1 58 38 68 53 0 0 0 0 0 0 0 0 0 0 0 0 0 0 0 0 0 0 62 5 5 5 5 5 5 5 5 33 8 8 8 8 36 5 5 5 24 26 1 30 28 5 5 5 5 5 27 25 11 29 31 5 5 24 26 30 28 65 
62 61 61 75 17 1 1 1 1 1 58 38 38 68 60 53 0 52 60 53 0 0 0 0 0 0 0 0 52 59 1 1 1 1 1 1 1 58 53 0 0 0 0 0 0 0 0 0 0 0 0 0 0 0 0 0 0 0 0 0 62 5 5 5 33 36 5 5 32 34 1 1 1 1 37 35 5 5 27 25 11 29 31 5 5 5 5 5 5 5 5 5 5 5 5 27 25 29 31 65 
62 5 5 33 21 1 1 1 58 38 53 0 0 0 0 0 0 0 0 0 0 0 0 0 0 0 0 0 0 52 38 38 59 1 1 1 1 47 0 0 0 0 0 0 0 0 0 0 0 0 0 0 0 0 0 0 0 0 0 0 62 5 5 32 34 37 35 5 24 26 1 1 1 1 30 28 5 5 5 5 5 5 5 5 5 5 5 5 5 5 5 5 5 5 5 5 5 5 5 65 
62 5 32 34 1 1 1 1 47 0 0 0 0 0 0 0 0 0 0 0 0 0 0 0 0 0 0 0 0 0 0 0 62 1 1 58 38 53 0 0 0 0 0 0 0 0 0 0 0 0 0 0 0 0 0 0 0 0 0 0 52 77 5 24 1 1 28 5 5 25 11 11 11 11 29 5 5 5 5 5 5 5 5 5 5 5 5 5 5 5 5 5 5 5 5 5 5 5 5 65 
52 60 69 38 38 38 38 38 53 0 0 0 0 0 0 0 0 0 0 0 0 0 0 0 0 0 0 0 0 0 0 0 52 38 38 53 0 0 0 0 0 0 0 0 0 0 0 0 0 0 0 0 0 0 0 0 0 0 0 0 0 52 60 60 38 38 60 60 60 60 60 60 60 60 60 60 60 60 60 60 60 60 60 60 60 60 60 60 60 60 60 60 60 60 60 60 60 60 60 53 
