54 41 41 41 41 41 41 41 41 41 41 41 41 41 41 41 41 41 41 41 41 41 41 41 41 41 41 41 41 41 41 41 41 41 41 41 41 41 41 41 41 41 41 41 41 41 41 41 41 55 0 0 0 0 0 0 0 0 0 0 
43 40 40 40 40 40 40 40 40 40 40 40 40 40 40 40 40 40 40 40 40 40 40 40 40 40 40 40 40 40 40 40 40 40 40 40 40 40 40 40 40 40 40 40 40 40 40 40 40 48 0 0 0 0 0 0 0 0 0 0 
43 40 40 40 40 40 40 40 40 40 40 40 40 40 40 40 40 40 40 40 40 40 40 40 40 40 40 40 40 40 40 40 40 40 40 40 40 40 40 40 40 40 40 40 40 40 40 40 40 48 0 0 0 0 0 0 0 0 0 0 
43 39 39 71 40 40 40 40 40 40 40 40 40 40 40 40 40 40 73 39 39 39 71 40 40 40 40 40 40 40 40 40 40 40 40 40 40 40 40 40 40 40 40 40 40 40 40 40 40 48 0 0 0 0 0 0 0 0 0 0 
42 1 1 70 61 61 61 61 61 61 61 61 61 61 61 61 61 61 72 1 1 1 70 61 61 61 61 61 61 61 61 61 61 61 61 61 61 61 61 61 61 61 61 61 61 61 61 61 61 67 41 55 0 0 0 0 0 0 0 0 
52 59 1 20 36 5 33 8 8 36 6 5 6 76 60 77 36 5 17 1 1 1 120 105 106 105 106 105 106 105 106 105 106 105 106 105 106 5 33 8 8 8 8 8 8 8 8 8 8 66 40 48 0 0 0 0 0 0 0 0 
0 42 1 58 38 60 38 38 38 38 60 77 5 65 0 43 37 35 17 1 1 1 20 8 36 5 5 76 68 60 60 77 5 6 5 6 82 32 34 1 1 1 1 1 1 1 1 1 1 49 40 48 0 0 0 0 0 0 0 0 
0 42 1 50 55 0 0 0 0 0 0 62 6 65 0 42 1 20 21 1 1 1 1 1 37 35 6 65 0 0 0 62 6 5 6 5 83 105 1 1 1 1 1 1 1 1 1 1 1 56 39 48 0 0 0 0 0 0 0 0 
0 42 1 49 48 54 41 41 41 41 41 64 5 67 41 45 1 1 1 1 1 58 38 59 1 20 8 65 0 0 0 52 60 60 77 36 5 17 1 1 1 1 1 1 1 1 1 1 1 1 129 47 0 0 0 0 0 0 0 0 
0 42 1 49 48 43 40 40 40 40 40 63 6 66 40 44 133 132 134 58 38 53 0 52 38 38 38 53 0 0 0 0 0 0 42 37 35 17 1 1 1 1 1 1 1 1 1 1 1 1 128 47 0 0 0 0 0 0 0 0 
0 42 1 39 48 43 40 40 40 40 40 63 5 66 40 44 1 1 1 50 41 41 41 41 41 41 41 41 55 0 0 0 0 0 42 1 14 17 1 1 1 1 1 1 1 1 1 1 1 58 38 53 0 0 0 0 0 0 0 0 
0 42 1 1 50 46 40 40 40 40 40 63 6 66 73 57 1 1 1 49 40 40 40 40 40 40 40 40 51 41 41 41 41 41 45 1 14 24 26 1 1 1 1 1 1 1 1 1 1 47 0 0 0 0 0 0 0 0 0 0 
0 42 1 1 49 63 61 61 61 61 61 75 5 74 72 1 1 1 1 49 40 40 40 40 40 40 40 40 152 40 40 40 40 40 44 30 28 27 25 11 23 1 1 1 1 1 1 1 1 47 0 0 0 0 0 0 0 0 0 0 
0 52 59 1 49 63 36 5 6 5 6 5 6 5 17 1 1 1 1 56 39 39 39 39 39 39 39 39 152 40 40 40 40 40 63 29 31 5 6 5 24 26 1 1 58 38 59 1 58 53 0 0 0 0 0 0 0 0 0 0 
0 0 42 1 56 57 37 35 5 6 5 6 5 6 17 1 1 1 1 1 1 1 1 1 1 1 1 1 56 39 39 39 39 39 57 35 5 6 5 6 27 25 11 11 65 0 62 82 65 0 0 0 0 0 0 0 0 0 0 0 
0 0 42 1 1 1 30 28 6 5 6 5 6 5 17 1 1 1 58 38 38 38 38 38 38 59 1 1 1 1 1 1 1 1 1 14 6 5 6 5 6 5 76 60 53 0 62 83 65 0 0 0 0 0 0 0 0 0 0 0 
0 0 42 1 1 22 29 31 5 6 5 6 5 6 17 1 1 1 47 0 0 0 0 0 0 52 38 38 38 38 38 38 38 59 1 28 5 6 5 6 5 6 65 0 0 0 62 82 65 0 0 0 0 0 0 0 0 0 0 0 
0 0 42 1 30 28 6 33 36 5 5 33 8 8 21 1 1 1 47 0 0 0 0 0 0 0 0 0 0 0 54 41 41 64 82 31 6 5 6 5 6 5 65 0 0 0 62 83 65 0 0 0 0 0 0 0 0 0 0 0 
0 0 62 82 29 5 32 1 37 35 32 34 1 1 1 1 1 1 47 0 0 0 0 0 0 0 0 0 0 0 43 40 40 63 82 6 5 6 5 6 5 6 65 0 0 0 62 82 65 0 0 0 0 0 0 0 0 0 0 0 
0 0 62 82 106 105 106 1 1 120 106 1 1 1 1 1 1 1 47 0 0 0 0 0 0 0 0 0 0 0 43 40 40 63 83 5 6 5 6 5 6 5 67 41 41 41 64 83 65 0 0 0 0 0 0 0 0 0 0 0 
0 0 62 6 5 5 76 38 38 77 17 1 1 1 1 1 1 1 47 0 0 0 0 0 0 0 0 0 0 0 43 40 40 63 82 6 5 6 5 6 5 6 66 40 40 40 63 82 65 0 0 0 0 0 0 0 0 0 0 0 
0 0 52 77 6 5 65 0 0 42 17 1 1 1 1 1 1 1 47 0 0 0 0 0 0 0 0 0 0 0 62 61 61 75 83 5 6 5 6 5 6 5 66 40 40 40 63 83 65 0 0 0 0 0 0 0 0 0 0 0 
0 0 0 62 5 6 65 0 0 52 69 38 59 1 1 1 1 1 50 55 0 0 0 0 0 0 0 0 0 0 52 77 5 6 82 6 5 33 8 36 5 6 66 40 40 40 63 82 65 0 0 0 0 0 0 0 0 0 0 0 
0 0 0 52 60 60 53 0 0 0 0 0 52 38 38 59 1 1 49 48 0 0 0 0 0 0 0 0 0 0 0 52 77 5 83 5 32 34 1 37 35 5 74 61 61 61 75 83 65 0 0 0 0 0 0 0 0 0 0 0 
0 0 0 0 0 0 0 0 0 0 0 0 0 0 0 42 1 1 49 48 0 0 0 0 0 0 0 0 0 0 0 0 62 6 105 106 105 1 1 1 120 106 105 6 33 8 8 97 67 55 0 0 0 0 0 0 0 0 0 0 
0 54 41 41 41 41 41 41 41 41 41 41 41 41 41 45 1 1 56 51 41 41 41 41 41 41 41 41 41 41 55 0 62 5 6 5 24 26 1 30 28 5 83 32 34 1 1 1 66 48 0 0 0 0 0 0 0 0 0 0 
0 43 40 40 40 40 40 40 40 40 40 40 40 40 40 44 1 1 1 49 40 40 40 40 40 40 40 40 40 40 48 0 62 6 5 6 27 25 82 29 31 6 82 105 1 1 1 1 66 48 0 0 0 0 0 0 0 0 0 0 
0 43 40 40 40 40 40 40 40 40 40 148 150 149 40 44 1 1 1 49 40 40 40 40 40 40 40 40 40 40 51 41 64 5 6 5 6 5 137 5 6 5 6 17 1 1 22 11 66 48 0 0 0 0 0 0 0 0 0 0 
0 43 40 40 40 40 40 40 40 40 40 67 41 64 39 57 1 1 1 56 39 39 39 71 40 40 73 39 39 39 152 40 63 6 5 6 5 6 97 36 5 6 5 17 1 1 14 6 74 65 0 0 0 0 0 0 0 0 0 0 
54 46 61 61 61 61 61 61 61 61 61 66 40 63 1 1 1 1 1 1 1 1 1 70 61 61 72 1 1 1 49 40 63 36 6 5 6 32 34 37 35 5 6 17 1 1 20 8 8 65 0 0 0 0 0 0 0 0 0 0 
43 63 6 5 6 5 6 5 6 5 6 66 40 63 1 1 1 1 22 11 23 1 1 14 5 5 17 1 1 1 56 39 57 37 35 6 5 17 1 1 14 6 5 24 26 1 1 1 1 65 0 0 0 0 0 0 0 0 0 0 
43 63 5 6 5 6 5 6 5 6 5 66 40 63 23 1 1 1 14 6 17 1 1 122 111 111 111 1 1 1 1 1 1 1 20 8 8 21 1 1 20 36 6 27 25 23 1 1 1 65 0 0 0 0 0 0 0 0 0 0 
43 63 6 5 76 60 77 5 6 5 6 74 61 75 17 1 1 1 20 8 21 1 1 121 107 110 107 1 1 1 1 1 1 1 1 1 1 1 1 1 1 37 35 6 5 17 1 1 22 65 0 0 0 0 0 0 0 0 0 0 
62 75 5 6 67 41 64 6 5 6 5 33 8 8 21 1 1 1 1 1 1 1 1 14 6 5 17 1 1 1 1 1 22 11 11 23 1 1 1 1 1 30 28 5 6 17 1 1 14 65 0 0 0 0 0 0 0 0 0 0 
62 5 6 5 66 40 63 5 6 5 32 1 1 1 1 1 1 1 1 1 1 1 1 14 5 6 24 26 1 1 1 30 28 6 5 17 1 1 1 1 22 29 31 6 5 17 1 1 14 65 0 0 0 0 0 0 0 0 0 0 
62 6 5 6 66 40 63 6 5 6 24 26 1 1 1 1 1 1 1 1 1 1 1 14 6 5 6 25 11 11 11 29 31 5 6 24 26 1 26 30 28 5 6 5 6 17 1 1 20 65 0 0 0 0 0 0 0 0 0 0 
52 77 6 5 66 40 73 5 76 77 27 25 11 84 88 11 11 11 11 23 1 1 1 14 5 6 5 6 5 6 5 6 5 6 5 27 25 84 88 29 31 6 5 6 5 24 26 1 1 65 0 0 0 0 0 0 0 0 0 0 
0 62 5 6 74 61 75 6 67 64 5 6 33 98 99 8 36 5 6 17 1 1 1 14 6 5 6 5 6 5 6 5 6 5 6 5 6 84 89 5 6 5 6 5 6 27 25 23 1 65 0 0 0 0 0 0 0 0 0 0 
0 62 6 5 6 5 6 5 66 63 6 32 34 1 1 1 37 35 5 24 26 1 30 28 5 6 5 6 5 6 5 6 5 6 5 6 5 85 88 6 5 6 5 6 5 6 5 24 26 65 0 0 0 0 0 0 0 0 0 0 
0 52 60 77 8 8 8 8 66 63 8 21 1 1 1 1 1 14 6 27 25 11 29 31 6 5 6 5 6 5 6 5 6 5 33 8 8 98 99 36 5 5 6 5 6 5 6 27 25 65 0 0 0 0 0 0 0 0 0 0 
0 0 0 42 1 1 1 1 146 147 1 1 1 1 1 1 1 14 5 6 5 6 5 6 5 6 5 6 5 6 5 6 5 32 1 1 1 1 1 37 35 6 5 6 5 6 5 6 5 65 0 0 0 0 0 0 0 0 0 0 
0 0 0 42 1 1 1 1 1 1 1 1 1 1 1 1 30 28 6 5 6 76 60 60 77 5 6 5 6 33 8 8 8 21 1 1 1 1 1 1 14 5 6 5 6 5 6 76 60 53 0 0 0 0 0 0 0 0 0 0 
54 41 41 45 1 1 1 1 1 1 1 1 1 1 1 22 29 31 5 6 5 65 0 0 52 77 5 6 32 34 1 1 1 1 1 1 1 1 1 1 14 6 5 6 76 60 60 53 0 0 0 0 0 0 0 0 0 0 0 0 
43 40 40 63 23 1 1 1 1 1 1 1 1 1 30 28 6 5 6 5 6 65 0 0 0 52 77 5 24 26 1 1 1 1 22 11 11 11 23 1 14 5 6 5 65 0 0 0 0 0 0 0 0 0 0 0 0 0 0 0 
43 40 40 63 17 1 1 1 1 1 1 1 1 22 29 31 5 6 5 76 60 53 0 0 0 0 62 6 27 25 23 1 1 1 14 6 33 8 21 1 14 76 60 60 53 0 0 0 0 0 0 0 0 0 0 0 0 0 0 0 
43 40 40 63 17 1 1 1 1 1 1 1 1 14 6 76 60 77 6 65 0 0 0 0 0 0 52 60 77 8 21 1 1 1 14 32 34 1 58 38 68 53 0 0 0 0 0 0 0 0 0 0 0 0 0 0 0 0 0 0 
62 61 61 75 17 1 1 1 1 1 58 38 38 68 60 53 0 52 60 53 0 0 0 0 0 0 0 0 52 59 1 1 1 1 20 21 1 58 53 0 0 0 0 0 0 0 0 0 0 0 0 0 0 0 0 0 0 0 0 0 
62 5 5 33 21 1 1 1 58 38 53 0 0 0 0 0 0 0 0 0 0 0 0 0 0 0 0 0 0 52 38 38 59 1 1 1 1 47 0 0 0 0 0 0 0 0 0 0 0 0 0 0 0 0 0 0 0 0 0 0 
62 6 32 34 1 1 1 1 47 0 0 0 0 0 0 0 0 0 0 0 0 0 0 0 0 0 0 0 0 0 0 0 62 1 1 58 38 53 0 0 0 0 0 0 0 0 0 0 0 0 0 0 0 0 0 0 0 0 0 0 
52 60 69 38 38 38 38 38 53 0 0 0 0 0 0 0 0 0 0 0 0 0 0 0 0 0 0 0 0 0 0 0 52 38 38 53 0 0 0 0 0 0 0 0 0 0 0 0 0 0 0 0 0 0 0 0 0 0 0 0 
0 0 0 0 0 0 0 0 0 0 0 0 0 0 0 0 0 0 0 0 0 0 0 0 0 0 0 0 0 0 0 0 0 0 0 0 0 0 0 0 0 0 0 0 0 0 0 0 0 0 0 0 0 0 0 0 0 0 0 0 
0 0 0 0 0 0 0 0 0 0 0 0 0 0 0 0 0 0 0 0 0 0 0 0 0 0 0 0 0 0 0 0 0 0 0 0 0 0 0 0 0 0 0 0 0 0 0 0 0 0 0 0 0 0 0 0 0 0 0 0 
0 0 0 0 0 0 0 0 0 0 0 0 0 0 0 0 0 0 0 0 0 0 0 0 0 0 0 0 0 0 0 0 0 0 0 0 0 0 0 0 0 0 0 0 0 0 0 0 0 0 0 0 0 0 0 0 0 0 0 0 
0 0 0 0 0 0 0 0 0 0 0 0 0 0 0 0 0 0 0 0 0 0 0 0 0 0 0 0 0 0 0 0 0 0 0 0 0 0 0 0 0 0 0 0 0 0 0 0 0 0 0 0 0 0 0 0 0 0 0 0 
0 0 0 0 0 0 0 0 0 0 0 0 0 0 0 0 0 0 0 0 0 0 0 0 0 0 0 0 0 0 0 0 0 0 0 0 0 0 0 0 0 0 0 0 0 0 0 0 0 0 0 0 0 0 0 0 0 0 0 0 
0 0 0 0 0 0 0 0 0 0 0 0 0 0 0 0 0 0 0 0 0 0 0 0 0 0 0 0 0 0 0 0 0 0 0 0 0 0 0 0 0 0 0 0 0 0 0 0 0 0 0 0 0 0 0 0 0 0 0 0 
0 0 0 0 0 0 0 0 0 0 0 0 0 0 0 0 0 0 0 0 0 0 0 0 0 0 0 0 0 0 0 0 0 0 0 0 0 0 0 0 0 0 0 0 0 0 0 0 0 0 0 0 0 0 0 0 0 0 0 0 
0 0 0 0 0 0 0 0 0 0 0 0 0 0 0 0 0 0 0 0 0 0 0 0 0 0 0 0 0 0 0 0 0 0 0 0 0 0 0 0 0 0 0 0 0 0 0 0 0 0 0 0 0 0 0 0 0 0 0 0 
0 0 0 0 0 0 0 0 0 0 0 0 0 0 0 0 0 0 0 0 0 0 0 0 0 0 0 0 0 0 0 0 0 0 0 0 0 0 0 0 0 0 0 0 0 0 0 0 0 0 0 0 0 0 0 0 0 0 0 0 
0 0 0 0 0 0 0 0 0 0 0 0 0 0 0 0 0 0 0 0 0 0 0 0 0 0 0 0 0 0 0 0 0 0 0 0 0 0 0 0 0 0 0 0 0 0 0 0 0 0 0 0 0 0 0 0 0 0 0 0 
