0 0 0 0 0 0 0 0 0 0 0 0 0 0 0 0 0 0 0 0 0 0 0 54 41 55 0 0 0 0 0 0 0 0 0 0 0 0 0 0 0 0 0 0 0 0 0 0 0 0 0 0 0 0 0 0 0 0 0 0 
0 0 0 0 0 0 0 0 0 0 0 0 0 0 0 0 0 54 41 41 55 0 54 46 40 51 55 0 0 0 0 0 0 0 0 0 0 0 0 0 0 0 0 0 0 0 0 0 0 0 0 0 0 0 0 0 0 0 0 0 
0 0 0 0 0 0 0 0 0 0 0 54 41 55 0 0 0 43 40 40 51 41 46 151 40 152 51 41 55 0 0 0 0 0 0 0 0 0 0 0 0 0 0 0 0 0 0 0 0 0 0 0 0 0 0 0 0 0 0 0 
0 0 0 0 0 0 0 0 0 0 54 46 40 51 41 41 41 46 40 40 152 40 151 151 39 152 152 40 51 55 0 0 0 0 0 0 0 0 0 0 0 0 0 0 0 0 0 0 0 0 0 0 0 0 0 0 0 0 0 0 
0 0 0 0 0 0 0 0 0 54 46 151 40 152 40 40 40 151 39 39 152 40 151 57 1 56 152 40 152 51 41 55 0 0 0 0 0 0 0 0 0 0 0 0 0 0 0 0 0 0 0 0 0 0 0 0 0 0 0 0 
0 0 0 0 0 0 0 0 54 46 151 151 39 152 40 40 40 151 1 1 56 39 57 1 1 1 56 39 152 152 40 48 0 0 0 0 0 0 0 0 0 0 0 0 0 0 0 0 0 0 0 0 0 0 0 0 0 0 0 0 
0 0 0 0 0 0 0 0 43 151 151 57 1 56 39 39 39 57 1 1 1 1 1 1 1 1 1 1 56 152 40 51 55 0 0 0 0 0 0 0 0 0 0 0 0 0 0 0 0 0 0 0 0 0 0 0 0 0 0 0 
0 0 0 0 0 0 0 54 46 151 57 1 1 1 1 1 1 1 1 1 1 1 1 1 1 1 1 1 1 56 39 152 48 0 0 0 0 0 0 0 0 0 0 0 0 0 0 0 0 0 0 0 0 0 0 0 0 0 0 0 
0 0 0 0 0 0 0 43 151 57 1 1 1 1 171 160 160 160 172 1 1 1 171 160 160 160 172 1 1 1 1 49 51 55 0 0 0 0 0 0 0 0 0 0 0 0 0 0 0 0 0 0 0 0 0 0 0 0 0 0 
0 0 0 0 0 0 0 43 151 1 1 1 1 30 176 156 155 156 166 1 1 1 163 156 155 156 173 26 1 1 1 56 152 48 0 0 0 0 0 0 54 41 55 0 0 0 54 41 55 0 0 0 0 0 0 0 0 0 0 0 
0 0 0 0 0 0 0 43 57 1 1 1 171 177 178 155 155 180 170 1 1 1 169 182 155 155 175 174 172 1 1 1 49 51 55 0 0 54 41 41 46 40 48 0 0 54 46 40 51 55 0 54 41 41 41 55 0 0 0 0 
0 0 0 0 0 0 0 43 1 1 1 1 163 156 155 156 179 34 1 1 1 1 1 37 181 156 155 156 166 1 1 1 56 152 51 41 41 46 40 40 151 40 51 41 41 46 151 40 152 51 41 46 40 40 40 51 41 41 41 55 
0 0 0 0 0 0 0 42 1 1 1 1 163 155 155 180 170 1 1 1 1 1 1 1 169 182 155 155 166 1 1 1 1 49 152 40 40 151 40 40 151 39 152 40 40 151 151 39 152 152 40 151 40 40 40 152 40 40 40 48 
0 0 0 0 0 0 0 42 1 1 1 1 163 156 179 34 1 1 1 1 1 1 1 1 1 37 181 156 166 1 1 1 1 56 152 40 40 151 39 39 57 1 49 40 40 151 57 1 56 152 40 151 39 39 39 152 40 40 40 48 
0 0 0 0 0 0 0 52 59 1 1 1 169 157 170 1 1 1 1 1 1 1 1 1 1 1 169 157 170 1 1 1 1 1 56 39 39 57 1 1 1 1 56 39 39 57 1 1 1 56 39 57 1 1 1 56 39 39 39 48 
0 0 0 0 0 0 0 0 42 1 1 1 1 1 1 1 1 1 1 183 184 185 1 1 1 1 1 1 1 1 1 1 1 1 1 1 1 1 1 1 1 1 1 1 1 1 1 1 1 1 1 1 1 1 1 1 1 1 129 47 
0 0 0 0 0 0 0 54 45 1 1 1 1 1 1 1 1 1 1 186 187 188 1 1 1 1 1 1 1 1 1 1 1 1 1 1 1 1 1 1 1 1 1 1 1 1 1 1 1 1 1 1 1 1 1 1 1 1 130 47 
0 0 0 0 0 0 54 46 44 1 1 1 1 1 1 1 1 1 1 189 190 191 1 1 1 1 1 1 1 1 1 1 1 1 1 1 1 1 1 1 1 1 1 1 1 1 1 1 1 1 1 1 1 1 1 1 1 1 128 47 
0 0 0 0 54 41 46 151 44 1 1 1 171 160 172 1 1 1 1 1 1 1 1 1 1 1 171 160 172 1 1 1 1 58 59 1 58 38 38 59 1 1 1 58 38 38 38 38 59 1 1 1 1 1 58 38 38 38 38 53 
0 0 0 0 43 40 151 151 57 1 1 1 163 156 173 26 1 1 1 1 1 1 1 1 1 30 176 156 166 1 1 1 58 53 52 38 53 0 0 52 38 38 38 53 0 0 0 0 52 59 1 1 58 38 53 0 0 0 0 0 
0 0 0 54 46 40 151 57 1 1 1 1 163 155 175 174 172 1 1 1 1 1 1 1 171 177 178 155 166 1 1 1 47 0 0 0 0 0 0 0 0 0 0 0 0 0 0 0 0 52 38 38 53 0 0 0 0 0 0 0 
0 54 41 46 151 39 57 1 1 1 1 1 163 156 155 156 173 26 1 1 1 1 1 30 176 156 155 156 166 1 1 58 53 0 0 0 0 0 0 0 0 0 0 0 0 0 0 0 0 0 0 0 0 0 0 0 0 0 0 0 
0 43 40 151 44 1 1 1 1 58 59 1 169 182 155 155 175 174 172 1 1 1 171 177 178 155 155 180 170 1 1 47 0 0 0 0 0 0 0 0 0 0 0 0 0 0 0 0 0 0 0 0 0 0 0 0 0 0 0 0 
54 46 40 151 57 1 1 1 1 47 42 1 1 37 181 156 155 156 166 1 1 1 163 156 155 156 179 34 1 1 58 53 0 0 0 0 0 0 0 0 0 0 0 0 0 0 0 0 0 0 0 0 0 0 0 0 0 0 0 0 
43 151 39 57 1 1 1 1 58 53 52 59 1 1 169 157 157 157 170 1 1 1 169 157 157 157 170 1 1 58 53 0 0 0 0 0 0 0 0 0 0 0 0 0 0 0 0 0 0 0 0 0 0 0 0 0 0 0 0 0 
43 44 1 1 1 1 1 58 53 0 0 52 59 1 1 1 1 1 1 1 1 1 1 1 1 1 1 1 1 47 0 0 0 0 0 0 0 0 0 0 0 0 0 0 0 0 0 0 0 0 0 0 0 0 0 0 0 0 0 0 
43 57 1 1 1 1 1 47 0 0 0 0 52 38 59 1 1 58 59 1 1 1 1 1 1 58 38 59 1 47 0 0 0 0 0 0 0 0 0 0 0 0 0 0 0 0 0 0 0 0 0 0 0 0 0 0 0 0 0 0 
42 1 1 1 1 58 38 53 0 0 0 0 0 0 52 38 38 53 52 38 59 1 1 1 58 53 0 52 38 53 0 0 0 0 0 0 0 0 0 0 0 0 0 0 0 0 0 0 0 0 0 0 0 0 0 0 0 0 0 0 
42 1 1 1 1 50 55 0 0 0 0 0 0 0 0 0 0 0 0 0 52 38 38 38 53 0 0 0 0 0 0 0 0 0 0 0 0 0 0 0 0 0 0 0 0 0 0 0 0 0 0 0 0 0 0 0 0 0 0 0 
42 1 1 1 1 49 51 41 55 0 0 0 0 0 0 0 0 0 0 0 0 0 0 0 0 0 0 0 0 0 0 0 0 0 0 0 0 0 0 0 0 0 0 0 0 0 0 0 0 0 0 0 0 0 0 0 0 0 0 0 
52 59 1 1 1 49 152 40 48 0 0 0 0 0 0 0 0 0 0 0 0 0 0 0 0 0 0 0 0 0 0 0 0 0 0 0 0 0 0 0 0 0 0 0 0 0 0 0 0 0 0 0 0 0 0 0 0 0 0 0 
0 42 1 1 1 56 152 40 51 55 0 0 0 0 0 0 0 0 0 0 0 0 0 0 0 0 0 0 0 0 0 0 0 0 0 0 0 0 0 0 0 0 0 0 0 0 0 0 0 0 0 0 0 0 0 0 0 0 0 0 
0 42 1 1 1 1 56 39 152 48 0 0 0 0 0 0 0 0 0 0 0 0 0 0 0 0 0 0 0 0 0 0 0 0 0 0 0 0 0 0 0 0 0 0 0 0 0 0 0 0 0 0 0 0 0 0 0 0 0 0 
0 52 59 1 1 1 1 1 49 51 55 0 0 0 0 0 0 0 0 0 0 0 0 0 0 0 0 0 0 0 0 0 0 0 0 0 0 0 0 0 0 0 0 0 0 0 0 0 0 0 0 0 0 0 0 0 0 0 0 0 
0 0 42 1 1 1 1 1 56 152 51 55 0 0 0 0 0 0 0 0 0 0 0 0 0 0 0 0 0 0 0 0 0 0 0 0 0 0 0 0 0 0 0 0 0 0 0 0 0 0 0 0 0 0 0 0 0 0 0 0 
0 0 42 1 1 1 1 1 1 49 152 51 41 55 0 0 0 0 0 0 0 0 0 0 0 0 0 0 0 0 0 0 0 0 0 0 0 0 0 0 0 0 0 0 0 0 0 0 0 0 0 0 0 0 0 0 0 0 0 0 
0 0 42 1 1 1 1 1 1 56 152 152 40 51 55 0 0 0 0 0 0 0 0 0 0 0 0 0 0 0 0 0 0 0 0 0 0 0 0 0 0 0 0 0 0 0 0 0 0 0 0 0 0 0 0 0 0 0 0 0 
0 0 52 59 1 1 1 1 1 1 56 152 40 152 48 0 0 0 0 0 0 0 0 0 0 0 0 0 0 0 0 0 0 0 0 0 0 0 0 0 0 0 0 0 0 0 0 0 0 0 0 0 0 0 0 0 0 0 0 0 
0 0 0 52 59 1 1 1 1 1 1 56 39 152 51 55 0 0 0 0 0 0 0 0 0 0 0 0 0 0 0 0 0 0 0 0 0 0 0 0 0 0 0 0 0 0 0 0 0 0 0 0 0 0 0 0 0 0 0 0 
0 0 0 0 52 59 1 1 1 1 1 1 1 56 152 51 55 0 0 0 0 0 0 0 0 0 0 0 0 0 0 0 0 0 0 0 0 0 0 0 0 0 0 0 0 0 0 0 0 0 0 0 0 0 0 0 0 0 0 0 
0 0 0 0 0 42 1 1 1 1 1 1 1 1 49 152 51 55 0 0 0 0 0 0 0 0 0 0 0 0 0 0 0 0 0 0 0 0 0 0 0 0 0 0 0 0 0 0 0 0 0 0 0 0 0 0 0 0 0 0 
0 0 0 0 0 42 1 1 1 1 1 1 1 1 56 152 152 51 55 0 0 0 0 0 0 0 0 0 0 0 0 0 0 0 0 0 0 0 0 0 0 0 0 0 0 0 0 0 0 0 0 0 0 0 0 0 0 0 0 0 
0 0 0 0 0 52 59 1 1 1 1 1 1 1 1 56 152 152 51 55 0 0 0 0 0 0 0 0 0 0 0 0 0 0 0 0 0 0 0 0 0 0 0 0 0 0 0 0 0 0 0 0 0 0 0 0 0 0 0 0 
0 0 0 0 0 0 42 1 1 1 1 1 1 1 1 1 56 152 152 48 0 0 0 0 0 0 0 0 0 0 0 0 0 0 0 0 0 0 0 0 0 0 0 0 0 0 0 0 0 0 0 0 0 0 0 0 0 0 0 0 
0 0 0 0 0 0 42 1 1 1 1 1 1 1 1 1 1 56 152 48 0 0 0 0 0 0 0 0 0 0 0 0 0 0 0 0 0 0 0 0 0 0 0 0 0 0 0 0 0 0 0 0 0 0 0 0 0 0 0 0 
0 0 0 0 0 0 52 59 1 1 1 1 1 1 1 1 1 1 56 48 0 0 0 0 0 0 0 0 0 0 0 0 0 0 0 0 0 0 0 0 0 0 0 0 0 0 0 0 0 0 0 0 0 0 0 0 0 0 0 0 
0 0 0 0 0 0 0 52 59 1 1 1 1 1 1 1 1 1 1 47 0 0 0 0 0 0 0 0 0 0 0 0 0 0 0 0 0 0 0 0 0 0 0 0 0 0 0 0 0 0 0 0 0 0 0 0 0 0 0 0 
0 0 0 0 0 0 0 54 45 1 1 1 1 1 1 1 1 1 1 47 0 0 0 0 0 0 0 0 0 0 0 0 0 0 0 0 0 0 0 0 0 0 0 0 0 0 0 0 0 0 0 0 0 0 0 0 0 0 0 0 
0 0 0 0 0 0 54 46 44 1 1 1 1 1 1 1 1 1 58 53 0 0 0 0 0 0 0 0 0 0 0 0 0 0 0 0 0 0 0 0 0 0 0 0 0 0 0 0 0 0 0 0 0 0 0 0 0 0 0 0 
0 0 0 0 0 54 46 151 44 1 1 1 1 1 1 1 1 58 53 0 0 0 0 0 0 0 0 0 0 0 0 0 0 0 0 0 0 0 0 0 0 0 0 0 0 0 0 0 0 0 0 0 0 0 0 0 0 0 0 0 
0 0 0 0 54 46 151 151 57 1 1 1 1 1 1 1 58 53 0 0 0 0 0 0 0 0 0 0 0 0 0 0 0 0 0 0 0 0 0 0 0 0 0 0 0 0 0 0 0 0 0 0 0 0 0 0 0 0 0 0 
0 0 0 0 43 151 151 57 1 1 1 1 1 1 1 1 47 0 0 0 0 0 0 0 0 0 0 0 0 0 0 0 0 0 0 0 0 0 0 0 0 0 0 0 0 0 0 0 0 0 0 0 0 0 0 0 0 0 0 0 
0 0 0 0 43 151 57 1 1 1 1 1 1 1 1 58 53 0 0 0 0 0 0 0 0 0 0 0 0 0 0 0 0 0 0 0 0 0 0 0 0 0 0 0 0 0 0 0 0 0 0 0 0 0 0 0 0 0 0 0 
0 0 0 0 43 57 1 1 1 1 1 1 1 1 58 53 0 0 0 0 0 0 0 0 0 0 0 0 0 0 0 0 0 0 0 0 0 0 0 0 0 0 0 0 0 0 0 0 0 0 0 0 0 0 0 0 0 0 0 0 
0 0 0 0 42 1 1 1 1 1 1 1 58 38 53 0 0 0 0 0 0 0 0 0 0 0 0 0 0 0 0 0 0 0 0 0 0 0 0 0 0 0 0 0 0 0 0 0 0 0 0 0 0 0 0 0 0 0 0 0 
0 0 0 0 42 1 1 1 1 1 1 58 53 0 0 0 0 0 0 0 0 0 0 0 0 0 0 0 0 0 0 0 0 0 0 0 0 0 0 0 0 0 0 0 0 0 0 0 0 0 0 0 0 0 0 0 0 0 0 0 
0 0 0 0 52 59 1 1 1 58 38 53 0 0 0 0 0 0 0 0 0 0 0 0 0 0 0 0 0 0 0 0 0 0 0 0 0 0 0 0 0 0 0 0 0 0 0 0 0 0 0 0 0 0 0 0 0 0 0 0 
0 0 0 0 0 42 1 1 58 53 0 0 0 0 0 0 0 0 0 0 0 0 0 0 0 0 0 0 0 0 0 0 0 0 0 0 0 0 0 0 0 0 0 0 0 0 0 0 0 0 0 0 0 0 0 0 0 0 0 0 
0 0 0 0 0 42 124 125 47 0 0 0 0 0 0 0 0 0 0 0 0 0 0 0 0 0 0 0 0 0 0 0 0 0 0 0 0 0 0 0 0 0 0 0 0 0 0 0 0 0 0 0 0 0 0 0 0 0 0 0 
0 0 0 0 0 52 38 38 53 0 0 0 0 0 0 0 0 0 0 0 0 0 0 0 0 0 0 0 0 0 0 0 0 0 0 0 0 0 0 0 0 0 0 0 0 0 0 0 0 0 0 0 0 0 0 0 0 0 0 0 
