0 0 0 0 0 0 0 0 0 0 0 0 0 0 0 0 0 0 0 0 0 0 0 0 0 0 0 0 0 0 0 0 0 0 0 0 54 41 41 55 0 0 0 0 0 0 0 0 0 0 0 0 0 0 0 0 54 41 41 41 55 0 0 0 0 54 41 41 41 41 41 41 41 41 55 
0 0 0 0 0 0 0 0 0 0 0 0 0 0 0 0 0 0 0 0 0 0 0 0 0 0 0 0 0 0 54 41 41 41 55 54 46 40 40 48 0 0 0 0 0 0 0 0 0 0 0 0 0 0 0 0 43 40 40 40 48 54 41 41 41 46 40 40 40 40 40 40 40 40 48 
0 0 0 0 0 0 0 0 0 0 0 0 0 0 0 0 0 0 0 0 0 0 0 0 0 0 0 0 54 41 46 40 40 40 51 46 151 40 40 51 41 41 41 41 41 41 41 55 0 0 0 0 0 0 0 0 43 40 40 40 51 46 40 40 40 151 40 40 40 40 40 40 40 40 48 
0 0 0 0 0 0 0 0 0 0 0 0 0 0 0 0 0 0 0 0 0 0 0 0 0 0 0 0 43 40 151 40 40 40 152 151 151 39 39 152 40 40 40 40 40 40 40 51 41 55 0 0 0 54 41 41 46 39 39 39 152 151 40 40 40 151 39 39 39 40 40 40 40 40 48 
0 0 0 0 0 0 0 0 0 0 0 0 0 0 0 0 0 0 0 0 0 0 0 41 41 41 41 41 46 40 151 39 39 39 152 151 57 1 1 49 40 40 40 40 40 40 40 152 40 51 55 0 0 43 40 40 44 1 22 23 49 151 39 39 39 57 1 1 30 70 61 61 61 61 65 
0 0 0 0 0 0 0 0 0 0 1 0 1 1 0 0 0 0 0 0 0 0 0 40 40 40 40 40 151 39 57 1 1 1 56 57 1 1 1 56 39 39 39 39 39 39 39 152 40 152 51 41 41 46 40 40 44 1 20 21 56 57 22 11 23 1 1 1 30 28 7 5 5 76 53 
0 0 0 0 0 0 1 1 58 59 1 1 1 1 0 0 0 0 0 0 0 0 0 40 40 40 40 40 44 1 1 1 1 1 1 1 1 1 1 1 1 1 1 1 1 1 1 56 39 152 152 40 40 151 39 39 57 1 1 1 1 1 20 8 21 1 30 22 29 31 7 5 5 67 55 
0 0 0 1 1 1 1 1 50 45 1 1 1 1 0 0 0 0 0 0 0 0 39 39 39 39 39 39 57 1 1 58 38 38 38 38 38 38 59 1 1 58 59 1 1 1 1 1 1 56 152 40 40 44 1 1 1 1 1 22 23 1 1 1 1 1 30 28 7 7 5 7 5 66 65 
0 0 0 0 0 0 1 1 49 44 1 1 1 1 1 1 1 1 1 1 1 1 1 1 1 1 1 1 1 1 1 47 0 0 0 0 0 54 46 1 1 47 42 1 58 38 59 1 1 1 56 39 39 57 1 1 22 11 23 20 21 1 1 1 22 11 29 31 7 5 7 5 5 66 65 
0 0 0 0 0 0 0 1 49 44 1 1 58 59 1 1 0 0 38 38 38 38 38 38 38 38 38 38 38 38 38 53 54 41 41 55 0 43 151 1 1 47 52 38 53 0 52 59 1 1 1 1 1 1 1 1 14 5 17 1 1 1 1 1 20 36 7 5 5 33 36 5 7 66 65 
0 0 0 0 0 0 0 1 56 57 1 1 50 45 1 0 0 0 0 0 0 0 0 0 0 0 0 0 0 54 41 41 46 40 40 51 41 46 151 1 58 53 54 41 41 41 55 52 38 59 1 1 58 38 59 1 20 8 21 1 1 22 23 1 1 37 35 7 32 34 37 35 5 74 65 
0 0 0 0 0 0 0 1 1 1 1 0 49 44 0 0 0 0 0 0 0 0 0 0 0 0 0 0 0 43 40 40 151 40 40 40 40 151 57 1 50 41 46 40 40 40 48 0 0 42 1 58 53 0 42 1 1 1 1 1 1 14 17 1 1 1 20 8 21 1 1 14 7 5 65 
0 0 0 0 0 0 0 0 0 0 0 0 49 44 0 0 0 0 0 0 0 0 0 0 0 0 0 0 54 46 40 40 151 39 39 152 40 44 1 1 49 40 151 40 40 40 51 55 0 52 38 53 0 0 52 59 1 1 58 59 1 20 21 1 22 23 1 1 1 1 1 14 5 7 65 
0 0 0 0 0 0 0 0 0 0 0 0 56 57 0 0 0 0 0 0 0 0 0 0 0 0 0 54 46 151 39 39 57 1 1 56 39 57 1 1 49 40 151 39 39 39 152 48 0 0 0 0 0 0 0 52 38 38 53 52 38 59 1 1 20 21 1 22 23 1 1 20 8 8 65 
0 0 0 0 0 0 0 0 0 0 0 0 0 0 0 0 0 0 0 0 0 0 0 0 0 0 0 43 151 44 1 1 1 1 1 1 1 1 1 1 56 39 57 1 1 1 49 51 41 41 41 55 0 0 0 0 0 0 0 0 0 42 1 1 1 1 1 20 21 1 1 1 1 1 47 
0 0 0 0 0 0 0 0 0 0 0 0 0 0 0 0 0 0 0 0 0 0 0 0 0 0 0 43 151 57 1 1 1 58 38 38 59 1 1 1 1 1 1 1 1 1 56 152 40 40 40 51 41 55 0 0 0 0 0 0 0 42 1 22 11 11 23 2 22 23 22 23 1 58 53 
0 0 0 0 0 0 0 0 0 0 0 0 0 0 0 0 0 0 0 0 0 0 0 0 0 0 0 43 57 1 1 1 58 53 0 0 52 38 59 1 1 1 1 58 59 1 1 49 40 40 40 152 40 51 55 0 0 0 0 0 0 42 1 20 36 7 17 1 20 21 14 17 1 47 0 
0 0 0 0 0 0 0 0 0 0 0 0 0 0 0 0 0 0 0 0 0 0 0 0 0 0 0 42 1 1 1 58 53 0 0 0 0 0 52 38 38 38 38 53 52 59 1 56 39 39 39 152 40 152 51 41 55 0 0 0 0 42 1 1 37 35 17 1 1 1 14 17 1 47 0 
0 0 0 0 0 0 0 0 0 0 0 0 0 0 0 0 0 0 0 0 0 0 0 0 0 0 0 42 1 1 1 50 41 55 0 0 0 0 0 0 0 0 0 0 0 42 1 1 1 1 1 56 39 152 152 40 51 55 0 0 0 52 59 1 1 20 21 22 23 1 20 21 1 47 0 
0 0 0 0 0 0 0 0 0 0 0 0 0 0 0 0 0 0 0 0 0 0 41 41 41 41 55 52 59 1 1 49 40 48 0 0 0 0 0 0 0 0 0 0 0 42 1 1 1 1 1 1 1 56 152 40 152 48 0 0 0 0 52 59 1 1 1 20 21 1 1 1 1 47 0 
0 0 0 0 0 0 0 0 0 0 0 0 0 0 0 0 0 0 0 0 0 0 40 40 40 40 51 41 45 1 1 49 40 48 0 0 0 0 0 0 0 0 0 0 0 52 38 38 38 38 59 1 1 1 56 39 152 51 55 0 0 0 0 42 1 1 58 59 58 38 38 59 1 47 0 
0 0 0 0 0 0 0 0 0 0 0 0 0 0 0 0 0 0 0 0 0 0 40 40 40 40 152 40 44 1 1 56 39 48 0 0 0 0 0 0 0 0 0 0 0 0 0 0 0 0 52 38 59 1 1 1 56 152 48 0 0 0 0 52 59 1 47 52 53 0 0 52 38 53 0 
0 0 0 0 0 0 0 0 0 1 1 1 1 1 1 1 1 1 1 1 1 1 39 39 39 39 152 40 44 1 1 1 1 47 0 0 0 0 0 0 0 0 0 0 0 0 0 0 0 0 0 0 52 38 59 1 1 49 48 0 0 0 0 0 52 38 53 0 0 0 0 0 0 0 0 
0 0 0 0 0 0 0 0 0 38 38 38 38 38 38 38 38 1 1 1 1 1 1 1 1 1 56 39 57 1 1 58 38 53 0 0 54 41 55 0 54 41 41 41 41 41 41 41 41 55 0 0 0 0 52 59 1 56 51 41 41 55 0 0 0 0 0 0 0 0 0 0 0 0 0 
0 0 0 0 0 0 0 0 0 0 0 0 0 0 0 0 0 1 1 1 1 1 1 1 1 1 1 1 1 1 1 50 41 41 41 41 46 40 51 41 46 40 40 40 40 40 40 40 40 48 0 0 0 0 0 42 1 1 49 40 40 48 0 0 0 0 0 0 0 0 0 0 0 0 0 
0 0 0 0 0 0 0 0 0 0 0 0 0 0 0 0 0 0 38 38 38 38 38 59 1 1 1 1 1 1 1 49 40 40 40 40 151 40 152 40 151 40 40 40 40 40 40 40 40 48 0 0 0 0 0 52 59 1 49 40 40 48 0 0 0 0 0 0 0 0 0 0 0 0 0 
0 0 0 0 0 0 0 0 0 0 0 0 0 0 0 0 0 0 0 0 0 0 0 52 38 38 38 38 59 1 1 49 40 40 40 40 151 39 152 40 151 39 39 39 39 39 39 39 39 48 0 0 0 0 0 0 42 1 56 39 39 48 0 0 0 0 0 0 0 0 0 0 0 0 0 
0 0 0 0 0 0 0 0 0 0 0 0 0 0 0 0 0 0 0 0 0 0 0 0 0 0 0 0 52 59 1 56 39 39 39 39 57 1 56 39 57 1 1 1 1 1 1 1 1 47 0 0 0 0 0 0 42 1 1 1 4 47 0 0 0 0 0 0 0 0 0 0 0 0 0 
0 0 0 0 0 0 0 0 0 0 0 0 0 0 0 0 0 0 0 0 0 0 0 0 0 0 0 0 0 42 1 1 1 1 1 1 1 1 1 1 1 1 1 1 1 1 1 1 58 53 0 0 0 0 0 0 52 38 38 59 1 47 0 0 0 0 0 0 0 0 0 0 0 0 0 
0 0 0 0 0 0 0 0 0 0 0 0 0 0 0 0 0 0 0 0 0 0 0 0 0 0 0 0 0 52 38 59 1 1 58 38 38 38 38 59 1 1 58 38 59 1 1 58 53 0 0 0 0 0 0 0 0 0 0 42 1 47 0 0 0 0 0 0 0 0 0 0 0 0 0 
0 0 0 0 0 0 0 0 0 0 0 0 0 0 0 0 54 41 41 41 41 41 41 55 0 0 0 0 0 0 0 52 59 1 47 0 0 0 0 52 38 38 53 0 42 1 1 47 0 0 0 0 0 0 0 54 41 41 41 45 1 47 0 0 0 0 0 0 0 0 0 0 0 0 0 
0 0 0 0 0 0 0 0 0 0 0 0 0 0 0 0 43 40 40 40 40 40 40 51 41 55 0 0 0 0 0 0 42 1 47 0 0 0 0 0 0 0 0 54 45 1 58 53 0 0 0 0 0 0 0 43 40 40 40 44 1 47 0 0 0 0 0 0 0 0 0 0 0 0 0 
0 0 0 0 0 0 0 0 0 0 0 0 0 0 0 0 43 40 40 40 40 40 152 152 40 51 41 41 41 41 41 41 45 1 47 0 0 0 0 0 0 54 41 46 44 1 47 0 0 0 0 0 0 0 0 43 40 40 40 44 1 50 41 41 41 41 41 41 55 0 0 0 0 0 0 
0 0 0 0 0 0 0 0 0 0 0 0 0 0 0 0 43 39 39 39 39 39 39 152 40 152 40 40 40 40 40 40 44 1 50 55 0 0 0 0 0 43 40 151 44 1 50 55 0 0 0 0 0 0 0 43 39 39 39 57 1 49 40 40 40 40 40 40 48 0 0 0 0 0 0 
0 0 0 0 0 0 0 0 0 0 0 0 0 0 0 0 42 129 1 1 1 1 1 56 39 152 40 40 40 40 40 40 44 1 49 48 0 0 0 0 54 46 40 151 57 1 49 48 0 0 0 0 0 0 0 42 1 1 1 1 1 49 40 71 40 40 40 40 48 0 0 0 0 0 0 
0 0 0 0 0 0 0 0 0 0 0 0 0 0 0 0 42 128 1 1 1 1 1 1 1 56 39 39 39 39 39 39 57 1 49 48 0 0 0 0 43 151 39 57 1 1 49 48 0 0 0 0 0 0 0 42 2 1 58 59 1 56 71 40 40 40 40 40 67 41 41 41 55 0 0 
0 0 0 0 0 0 0 0 0 0 0 0 0 0 0 0 52 38 38 38 59 1 1 1 1 1 1 1 1 1 1 1 1 1 56 48 0 0 0 0 43 44 1 1 1 1 56 51 55 0 0 0 0 0 0 42 1 1 50 45 1 1 70 61 61 61 61 61 66 40 40 40 48 0 0 
0 0 0 0 0 0 0 17 0 0 0 0 0 0 0 0 0 0 0 0 52 38 59 1 1 1 1 1 1 1 1 1 1 1 1 65 0 0 0 0 43 57 1 22 11 23 1 49 48 0 0 0 54 41 41 45 1 1 49 44 1 1 14 6 5 6 5 6 66 40 40 40 48 0 0 
0 0 0 0 0 0 0 17 0 0 0 0 0 0 0 0 0 0 0 0 0 0 52 38 38 38 38 38 38 59 1 1 1 1 22 67 55 0 0 0 42 1 1 14 7 17 1 49 48 0 0 0 43 40 40 44 1 1 49 44 1 1 20 36 5 5 6 5 66 40 40 40 48 0 0 
0 0 0 0 0 0 14 17 0 1 0 0 0 0 0 0 0 0 0 0 0 0 0 0 0 0 0 54 41 45 1 1 1 30 28 66 48 0 0 0 52 59 1 20 8 21 1 56 48 0 0 54 46 40 40 44 1 1 56 57 1 1 1 37 35 6 5 7 74 61 61 61 65 0 0 
0 0 0 0 0 0 14 17 0 1 0 0 0 0 0 0 0 0 0 0 0 0 0 0 0 0 0 43 40 44 1 1 22 29 31 66 48 0 0 0 0 42 1 1 1 1 1 1 48 0 0 43 151 39 39 57 1 1 1 1 1 1 1 1 122 111 114 111 112 111 112 111 65 0 0 
0 0 0 0 0 0 14 17 0 1 0 0 0 0 0 0 0 0 0 0 0 0 0 0 0 0 54 46 40 44 1 30 14 7 5 66 48 0 0 0 0 52 38 59 1 58 38 38 53 0 0 43 44 1 1 1 1 1 1 1 3 1 1 1 121 108 107 108 107 108 109 108 65 0 0 
0 0 0 0 0 0 0 0 0 1 0 0 0 0 0 0 0 0 0 0 0 41 41 41 41 41 46 151 39 57 1 1 14 5 7 74 65 0 0 0 0 54 41 45 1 50 41 41 41 41 41 46 57 1 1 1 1 1 1 1 1 1 1 1 14 5 7 7 76 60 60 60 53 0 0 
0 0 0 0 0 0 0 0 0 1 0 0 0 0 0 0 0 0 0 0 0 40 40 40 40 40 151 151 1 1 1 30 28 7 5 5 65 0 0 0 0 43 40 44 1 49 40 40 40 40 40 44 1 1 1 1 1 22 11 11 23 1 1 58 68 60 60 60 53 54 41 55 0 0 0 
0 0 0 0 0 0 0 0 0 1 0 0 0 0 0 0 0 0 0 0 0 40 40 40 40 40 151 57 1 1 22 29 31 5 7 76 53 0 0 0 0 43 40 44 1 49 40 40 40 40 40 44 1 4 1 1 58 68 60 60 69 38 38 53 0 0 0 0 0 43 40 48 0 0 0 
0 0 0 0 0 0 0 0 0 1 0 0 0 0 0 0 0 0 0 0 0 39 39 39 39 39 57 1 1 1 20 8 8 8 8 65 0 0 0 0 0 43 39 57 1 56 39 39 39 39 39 57 1 1 1 58 53 0 0 0 0 0 0 0 0 0 0 0 0 43 40 48 0 0 0 
0 0 0 0 0 0 0 0 0 1 1 0 0 42 1 51 55 0 0 0 0 1 1 1 1 1 1 1 1 1 1 1 1 1 1 47 0 0 0 0 0 42 1 1 1 1 1 1 1 1 1 1 1 1 58 53 0 0 0 0 0 0 0 0 0 0 0 0 0 43 39 51 55 0 0 
0 0 0 0 0 0 0 0 0 1 1 0 0 42 1 49 51 55 0 0 0 38 38 38 59 1 58 38 38 38 38 38 38 59 1 47 0 0 0 0 0 52 38 38 38 38 59 1 1 58 38 38 38 38 53 0 0 0 0 0 0 0 0 0 0 0 0 0 0 42 1 49 48 0 0 
0 0 0 0 0 0 0 0 0 1 1 1 1 42 1 49 152 51 55 0 0 0 0 54 45 1 47 54 41 41 41 41 55 52 38 53 0 0 0 0 0 0 0 0 0 0 42 1 1 50 41 55 0 0 0 0 0 0 0 0 0 0 0 0 0 0 0 0 0 42 1 49 48 0 0 
0 0 0 0 0 0 0 0 0 0 0 0 0 42 1 56 152 152 48 0 0 0 0 43 44 1 47 43 40 40 40 40 48 0 0 0 0 0 0 0 0 0 0 54 41 41 64 11 11 66 40 48 0 0 0 0 0 0 0 0 0 0 0 0 0 0 0 0 0 42 1 56 48 0 0 
0 0 0 0 0 0 0 0 0 0 0 0 0 42 1 1 56 152 48 0 0 0 0 43 44 1 47 43 40 40 40 40 48 0 0 0 0 0 54 41 41 41 41 46 40 40 40 7 5 66 40 48 0 0 0 0 0 0 0 0 0 0 0 0 0 0 0 0 0 42 1 1 48 0 0 
0 0 0 0 0 0 0 0 0 0 0 0 0 42 1 1 1 56 48 0 0 0 0 43 57 1 47 43 39 39 39 39 48 0 0 0 0 54 46 40 40 40 40 151 40 40 40 5 7 66 40 51 55 0 0 0 0 0 0 0 0 0 0 0 0 0 0 0 0 52 59 1 48 0 0 
0 0 0 0 0 0 0 0 0 0 0 0 0 52 38 59 1 1 47 0 0 0 0 42 1 1 50 45 1 1 1 1 47 0 0 0 54 46 151 40 40 40 40 151 40 40 40 7 5 74 61 152 51 41 41 41 41 41 41 41 41 41 55 0 0 0 54 41 41 41 45 1 48 0 0 
0 0 0 0 0 0 0 0 0 0 0 0 0 0 0 52 59 1 47 0 0 0 0 42 1 1 49 44 1 58 59 1 47 0 54 41 46 151 151 40 40 40 40 40 61 61 75 7 5 7 5 152 152 40 40 40 40 40 40 40 40 40 48 0 0 54 46 40 40 40 44 1 47 0 0 
0 0 0 0 0 0 0 0 0 0 0 0 0 0 0 0 42 1 47 0 0 0 0 52 59 1 49 44 135 47 42 1 47 0 43 40 151 151 63 61 61 61 61 75 7 5 7 5 7 7 5 66 152 40 40 40 40 40 40 40 40 40 51 41 41 46 151 40 40 40 44 1 47 0 0 
0 0 0 0 0 0 0 0 0 0 0 0 0 0 0 0 42 1 47 0 0 0 0 0 42 1 56 57 1 47 42 1 50 41 46 40 151 63 75 5 5 5 5 7 5 7 7 5 7 5 7 74 66 40 148 150 150 149 40 40 40 40 152 40 40 151 151 40 73 39 57 1 47 0 0 
0 0 0 0 0 0 0 0 0 0 0 0 0 0 0 0 42 1 47 0 0 0 0 0 42 1 1 1 1 47 43 1 49 40 151 40 63 75 7 5 5 5 5 7 5 7 7 7 5 7 7 5 74 61 67 41 41 64 61 61 61 61 66 40 40 151 63 61 72 1 1 1 47 0 0 
0 0 0 0 0 0 0 0 0 0 0 0 0 0 0 0 42 1 47 0 0 0 0 0 52 38 38 38 38 53 43 1 49 40 63 61 75 5 7 7 5 7 7 5 7 5 7 7 7 7 5 7 5 7 66 40 40 63 5 7 5 5 66 40 40 63 75 5 17 1 58 38 53 0 0 
0 0 0 0 0 0 0 0 0 0 0 0 0 0 0 0 42 1 47 0 0 0 0 0 0 0 0 0 0 0 43 1 56 71 63 5 7 7 7 5 7 5 7 5 5 5 5 7 5 7 7 5 7 5 66 40 40 63 7 5 7 7 74 61 61 75 5 7 17 1 47 0 0 0 0 
0 0 0 0 0 0 0 0 0 0 0 0 0 0 0 54 45 1 50 41 41 41 41 41 41 41 55 0 0 0 42 1 1 70 75 7 7 7 7 7 5 7 5 5 7 7 7 7 7 5 7 7 5 7 66 40 40 63 7 7 7 5 5 5 5 5 5 7 17 1 50 55 0 0 0 
0 0 0 0 0 0 0 0 0 0 0 0 0 0 54 46 44 1 49 40 40 40 40 40 40 40 51 41 41 41 45 1 1 14 5 7 33 36 5 5 7 7 5 7 5 5 7 7 7 5 5 7 7 5 74 61 61 75 5 5 7 7 5 5 5 5 7 5 17 1 66 51 41 41 55 
0 0 0 0 0 0 0 0 0 0 0 0 0 0 43 151 44 1 49 40 40 40 40 40 40 40 152 40 40 40 44 1 1 14 7 32 34 37 35 7 5 5 7 5 5 7 5 7 5 7 7 7 5 5 5 5 5 5 5 7 5 7 7 7 5 7 5 7 17 1 66 152 40 40 48 
0 0 0 0 0 0 0 0 0 0 0 0 0 0 43 151 57 1 56 39 39 39 39 39 39 39 152 40 40 40 44 1 1 20 8 21 1 1 14 7 7 7 7 5 7 5 7 5 7 5 7 5 7 7 5 5 5 5 7 5 7 5 7 5 7 7 7 5 17 1 56 152 40 40 48 
0 0 0 0 0 0 0 0 0 0 0 0 0 0 43 57 1 1 1 1 1 1 1 1 1 1 56 39 39 39 57 1 1 1 1 1 1 1 122 111 111 111 111 111 111 111 111 111 111 111 111 111 111 111 111 111 111 111 111 111 111 111 111 111 111 111 111 111 111 1 1 56 39 39 48 
0 0 0 0 0 0 0 0 0 0 0 0 0 0 42 1 1 3 1 58 38 38 38 38 59 1 1 1 1 4 1 1 1 1 1 1 1 1 119 101 101 101 101 101 101 101 101 101 101 101 101 101 101 101 101 101 101 101 101 101 101 101 101 101 101 101 101 101 101 1 1 1 1 129 47 
0 0 0 0 0 0 0 0 0 0 0 0 0 0 42 1 1 58 38 53 0 0 0 0 52 38 38 38 59 1 1 1 1 1 1 1 1 1 119 101 101 101 101 101 101 101 101 101 101 101 101 101 101 101 101 101 101 101 101 101 101 101 101 101 101 101 101 101 101 1 1 1 1 130 47 
0 0 0 0 0 0 0 0 0 0 0 0 0 0 52 59 1 47 0 0 0 0 0 0 0 0 0 0 52 38 59 1 1 1 1 1 1 1 119 101 101 101 101 101 101 101 101 101 101 101 101 101 101 101 101 101 101 101 101 101 101 101 101 101 101 101 101 101 101 1 1 1 1 128 47 
0 0 1 1 0 0 0 0 0 0 0 0 0 0 0 42 1 47 0 0 0 0 0 0 0 0 0 0 0 0 52 38 38 59 1 1 1 1 121 107 107 107 107 107 107 107 107 107 107 107 107 107 107 107 107 107 107 107 107 107 107 107 107 107 107 107 107 107 107 1 1 1 58 38 53 
0 0 1 1 1 0 0 0 0 0 0 0 0 0 54 45 1 47 0 0 0 0 0 0 0 0 0 0 0 0 0 0 0 42 1 1 1 30 28 7 5 7 7 7 7 7 5 5 7 5 5 7 5 5 5 7 7 5 7 5 7 7 7 5 7 5 5 7 24 1 1 58 53 0 0 
62 11 23 1 1 1 50 41 41 41 41 41 41 41 46 44 1 47 0 0 0 0 0 0 0 0 0 0 0 0 0 0 0 62 11 11 11 29 31 5 7 5 7 5 5 5 7 5 5 5 7 5 5 7 7 5 7 7 5 7 7 5 7 7 5 7 7 5 76 38 38 53 0 0 0 
62 5 17 1 1 1 49 40 40 40 40 40 40 40 151 152 1 47 0 0 0 0 0 0 0 0 0 0 0 0 0 0 0 52 77 5 5 5 7 5 5 7 5 7 7 5 5 7 5 7 5 7 7 5 5 7 5 7 7 5 7 7 5 7 7 5 5 5 65 0 0 0 0 0 0 
52 77 24 26 1 1 49 40 40 40 40 40 40 40 151 57 1 47 0 0 0 0 0 0 0 0 0 0 0 0 0 0 0 0 62 5 5 5 7 5 7 5 7 5 5 7 5 7 7 5 7 5 5 7 7 5 7 7 5 7 5 5 7 7 5 7 5 76 53 0 0 0 0 0 0 
0 62 27 25 23 1 56 39 39 39 39 39 39 39 57 1 1 47 0 0 0 0 0 0 0 0 0 0 0 0 0 0 0 0 52 77 5 5 5 7 5 5 5 7 5 7 7 5 7 7 5 7 5 5 7 7 5 5 7 7 5 7 5 5 7 5 76 53 0 0 0 0 0 0 0 
0 52 77 5 17 1 1 1 1 1 1 1 1 1 1 1 1 47 0 0 0 0 0 0 0 0 0 0 0 0 0 0 0 0 0 52 60 77 5 7 5 7 7 5 7 5 5 7 5 5 5 5 5 7 5 5 7 7 7 5 7 5 5 7 5 76 53 0 0 0 0 0 0 0 0 
0 0 52 60 69 38 38 38 38 38 38 38 38 38 38 38 38 53 0 0 0 0 0 0 0 0 0 0 0 0 0 0 0 0 0 0 0 52 60 60 60 60 60 60 60 60 60 60 60 60 60 60 60 60 60 60 60 60 60 60 60 60 60 60 60 53 0 0 0 0 0 0 0 0 0 
