54 41 41 41 41 41 41 41 41 55 0 0 0 0 54 41 41 41 55 0 0 0 0 0 0 0 0 0 0 0 0 0 0 0 0 0 0 0 0 0 0 0 0 0 0 54 41 41 55 0 0 0 0 0 0 0 0 0 0 0 
43 40 40 40 40 40 40 40 40 51 41 41 41 55 43 40 40 40 48 0 0 0 0 0 0 0 0 0 0 0 0 0 0 0 0 0 0 0 54 41 41 41 41 41 55 43 40 40 51 41 41 41 41 41 41 41 41 41 41 55 
43 40 40 40 40 40 40 40 40 152 152 40 40 51 46 40 40 40 48 0 0 0 0 0 0 0 0 0 0 0 0 0 0 0 0 0 54 41 46 40 40 40 40 40 51 46 40 40 152 40 40 40 40 40 40 40 40 40 40 48 
43 40 40 40 40 73 39 39 39 152 40 40 40 152 151 39 39 39 51 41 41 55 0 0 0 0 0 0 0 0 0 0 0 0 0 0 43 40 151 40 40 40 40 40 152 151 39 39 152 40 40 40 40 40 40 40 40 40 40 48 
62 61 61 61 61 72 1 1 1 56 39 39 39 152 44 22 23 1 49 40 40 48 0 0 0 0 54 41 41 41 41 41 41 41 41 41 46 40 151 39 71 40 73 39 152 44 1 1 56 71 40 73 39 39 39 39 39 39 39 48 
52 77 5 6 7 24 26 1 1 1 22 11 23 56 57 20 21 1 49 40 40 51 41 41 55 0 43 40 40 40 40 40 40 40 40 40 151 39 57 153 70 61 72 153 56 57 133 134 1 70 61 72 1 1 1 1 1 1 129 47 
54 64 6 5 7 27 25 23 1 1 20 8 21 1 1 1 1 1 56 39 39 152 40 40 51 41 46 40 40 40 40 40 40 40 40 40 44 1 1 30 28 5 24 26 1 1 1 1 30 28 5 17 1 1 1 1 1 1 128 47 
43 63 5 7 5 7 7 24 26 1 1 1 1 1 22 23 1 1 1 1 1 49 40 40 152 40 151 39 39 39 39 39 39 39 39 39 57 1 22 29 31 6 27 25 11 11 11 82 29 31 5 17 1 1 1 1 58 38 38 53 
43 63 6 5 7 5 7 27 25 11 23 1 1 1 20 21 22 11 23 1 1 56 39 39 152 40 44 1 1 1 1 1 1 1 1 1 1 30 28 76 60 60 60 60 60 60 77 97 8 8 8 21 1 1 58 38 53 0 0 0 
43 63 7 6 5 6 5 6 7 33 21 1 1 1 1 1 14 6 17 1 1 1 1 1 56 39 57 1 22 11 11 11 11 11 11 11 11 29 31 65 0 0 0 0 0 0 42 1 1 1 1 1 1 58 53 0 0 0 0 0 
62 75 6 5 6 7 6 7 32 34 1 1 22 23 1 1 20 8 21 1 58 38 59 1 1 1 1 30 28 5 6 5 6 33 8 36 6 5 76 53 0 0 0 0 0 0 52 38 59 1 58 38 38 53 0 0 0 0 0 0 
62 6 7 6 33 8 8 8 21 1 1 1 14 17 1 1 1 1 1 1 47 0 62 11 11 11 11 29 31 76 60 77 32 34 1 37 35 6 65 0 0 0 0 0 54 41 55 0 42 153 47 0 0 0 0 0 0 0 0 0 
62 7 6 32 34 1 1 1 1 22 23 1 20 21 1 58 59 1 1 58 53 0 62 7 6 7 6 7 76 53 0 62 24 26 153 30 28 5 65 0 0 0 0 0 43 40 48 0 52 38 53 0 0 0 0 0 0 0 0 0 
62 8 8 21 1 1 22 23 1 20 21 1 1 58 38 53 52 38 38 53 0 0 62 6 7 6 5 6 65 0 0 62 27 25 11 29 31 76 53 0 0 0 0 0 43 40 48 0 0 0 0 0 0 0 0 0 0 0 0 0 
42 1 1 1 1 1 20 21 1 1 1 1 1 47 54 41 41 41 55 0 0 0 52 60 60 77 6 76 53 0 0 52 60 60 60 60 60 53 0 0 0 0 0 0 43 39 48 0 0 0 0 0 0 0 0 0 0 0 0 0 
52 59 1 22 23 22 23 1 22 11 11 23 1 47 43 40 40 40 51 41 55 0 0 0 0 62 5 65 0 0 0 54 41 41 41 41 55 0 0 0 54 41 41 41 45 1 47 0 0 0 0 0 0 0 0 0 0 0 0 0 
0 42 1 14 17 20 21 1 14 6 33 21 1 47 43 40 40 40 152 40 48 0 0 0 0 62 6 65 0 0 0 43 40 40 40 40 48 0 0 0 43 40 40 40 44 1 47 0 0 0 0 0 0 0 0 0 0 0 0 0 
0 42 1 14 17 1 1 1 14 32 34 1 1 47 43 39 39 39 152 40 48 0 0 54 41 64 5 67 41 55 0 43 40 40 40 40 48 0 0 0 43 40 40 40 44 1 50 41 41 41 41 41 41 55 0 0 0 0 0 0 
0 42 1 20 21 1 22 23 20 21 1 1 58 53 42 154 1 1 56 39 51 41 41 46 40 63 6 66 40 51 41 46 39 39 39 39 48 0 0 0 43 39 39 39 57 1 49 40 40 40 40 40 40 48 0 0 0 0 0 0 
0 42 1 1 1 1 20 21 1 1 1 58 53 0 52 38 59 1 1 1 49 40 40 151 40 63 5 66 40 152 40 44 1 1 1 154 47 0 0 0 42 1 1 1 1 1 49 40 71 40 40 40 40 48 0 0 0 0 0 0 
0 42 1 58 38 38 59 58 38 59 153 47 0 0 0 0 52 38 59 1 49 40 40 151 71 63 6 66 73 152 40 44 1 58 38 38 53 0 0 0 42 1 1 58 59 1 56 71 40 40 40 40 40 51 41 41 41 55 0 0 
0 42 153 47 0 0 52 53 0 52 38 53 0 0 0 0 0 0 42 1 56 39 39 57 70 75 5 74 72 56 39 57 1 47 0 0 0 54 41 55 42 1 1 50 45 1 1 70 61 61 61 61 61 66 40 40 40 48 0 0 
0 52 38 53 0 0 0 0 0 0 0 0 0 0 0 0 0 0 42 1 1 1 1 1 120 105 106 105 105 1 1 1 1 47 0 0 0 43 40 51 45 1 1 49 44 1 1 14 6 5 6 5 6 66 40 40 40 48 0 0 
0 0 0 0 0 0 0 0 0 0 0 0 0 0 0 0 0 0 52 38 38 59 1 58 68 60 77 6 76 59 1 58 38 53 0 0 0 43 40 152 44 1 1 49 44 1 1 20 36 6 5 6 5 66 40 73 39 48 0 0 
0 0 0 0 0 0 0 0 0 0 0 0 0 0 0 0 0 54 41 41 41 45 1 47 0 0 62 5 65 42 1 47 0 0 0 0 54 46 39 152 44 1 1 56 57 1 1 1 37 35 6 5 7 74 61 72 153 47 0 0 
0 0 0 0 0 0 0 0 0 0 0 0 0 0 0 0 0 43 40 40 40 44 1 47 0 0 62 6 65 52 38 53 0 0 0 0 43 44 153 56 57 1 1 1 1 1 1 1 1 122 111 118 111 112 111 111 1 47 0 0 
0 0 0 0 0 54 41 55 0 0 0 0 0 0 0 0 0 43 40 40 40 44 1 47 0 0 62 5 67 55 0 54 41 55 0 0 43 44 1 1 1 1 1 1 1 1 1 1 1 121 108 107 108 107 110 107 1 47 0 0 
0 0 0 0 0 43 40 48 0 0 0 0 0 0 0 0 0 43 39 39 39 57 1 47 0 0 62 6 66 51 55 43 40 51 41 41 46 57 1 1 1 1 1 1 1 1 1 1 1 14 5 7 7 76 60 60 38 53 0 0 
0 0 0 0 0 43 40 48 0 0 0 0 0 0 0 0 0 42 1 1 1 1 1 47 0 0 62 5 66 152 48 43 40 152 40 40 44 1 1 1 1 1 1 22 11 11 11 23 58 68 60 60 60 53 54 41 55 0 0 0 
0 0 0 0 54 46 39 51 41 55 0 0 0 0 0 0 0 42 1 58 38 38 38 53 0 0 62 6 66 152 48 43 39 152 40 40 44 1 1 1 1 58 38 68 60 69 60 69 53 0 0 0 0 0 43 40 48 0 0 0 
0 0 0 54 46 44 1 49 40 48 0 0 0 0 0 0 0 42 153 47 0 0 0 0 0 0 62 5 74 66 48 42 153 56 39 39 57 1 1 1 58 53 0 0 0 0 0 0 0 0 0 0 0 0 43 40 48 0 0 0 
0 0 0 43 151 44 1 49 40 51 41 41 41 55 0 0 0 52 38 53 0 0 0 0 0 0 62 6 5 74 65 42 1 1 1 1 1 1 1 58 53 0 0 0 0 0 0 0 0 0 0 0 0 0 43 39 51 55 0 0 
0 0 0 43 151 57 1 56 39 152 40 40 40 48 0 0 0 0 0 0 0 0 0 0 0 0 52 77 6 5 65 42 1 1 58 38 38 38 38 53 0 0 0 0 0 0 0 0 0 0 0 0 0 0 42 1 49 48 0 0 
0 0 0 43 57 1 1 1 1 49 40 40 40 48 0 0 0 0 0 0 0 0 0 0 0 0 0 52 77 6 65 42 1 1 50 41 55 0 0 0 0 0 0 0 0 0 0 0 0 0 0 0 0 0 42 1 49 48 0 0 
0 0 0 42 1 1 58 59 1 56 39 39 39 48 0 0 0 0 0 0 0 0 0 0 0 0 0 0 62 5 67 64 11 11 66 40 48 0 0 0 0 0 0 0 0 0 0 0 0 0 0 0 0 0 42 1 56 48 0 0 
0 54 41 45 1 1 47 42 1 1 1 1 1 47 0 0 0 0 0 0 0 0 0 54 41 41 41 41 64 6 66 63 7 6 66 40 48 0 0 0 0 0 0 0 0 0 0 0 0 0 0 0 0 0 42 1 1 48 0 0 
0 43 40 44 135 58 53 52 38 38 59 1 58 53 0 0 0 0 0 0 0 0 54 46 40 40 40 40 63 5 66 63 6 7 66 40 51 55 0 0 0 0 0 0 0 0 0 0 0 0 0 0 0 0 52 59 1 48 0 0 
0 43 40 44 1 47 0 0 0 0 42 135 47 0 0 0 0 0 0 0 54 41 46 151 40 40 40 40 63 6 66 63 7 6 74 61 66 51 41 41 41 41 41 41 41 41 41 55 0 0 0 54 41 41 41 45 1 48 0 0 
0 43 39 57 1 47 0 0 0 0 42 1 47 0 0 0 0 0 0 0 43 40 151 151 40 40 40 40 63 5 74 75 7 5 7 5 66 152 40 40 40 40 40 40 40 40 40 48 0 0 54 46 40 40 40 44 1 47 0 0 
0 42 1 1 1 47 0 0 0 0 42 1 47 0 0 0 0 0 0 0 43 40 151 63 61 61 61 61 75 6 5 7 5 7 7 6 66 152 40 40 40 40 40 40 40 40 40 51 41 41 46 151 40 40 40 44 1 47 0 0 
0 42 1 1 58 53 0 0 54 41 45 1 47 0 0 0 54 41 41 41 46 40 63 75 6 5 6 5 7 5 7 7 6 7 6 7 74 66 40 148 150 150 149 40 40 40 40 152 40 40 151 151 40 73 39 57 1 47 0 0 
0 42 1 58 53 0 0 0 43 40 44 1 47 0 0 54 46 40 40 40 151 61 75 7 5 6 5 6 7 7 7 7 7 6 7 7 5 74 61 67 41 41 64 61 61 61 61 66 40 40 151 63 61 72 1 1 1 47 0 0 
0 42 1 47 0 0 0 0 43 40 44 1 47 0 0 43 151 40 40 40 63 5 7 7 7 5 7 7 6 7 5 7 7 7 7 5 7 5 7 66 40 40 63 5 7 5 6 66 40 40 63 75 6 17 1 58 38 53 0 0 
0 42 1 47 0 0 0 0 43 39 57 1 47 0 0 43 151 39 71 40 63 7 5 7 5 7 5 7 7 6 5 6 7 6 7 7 5 7 5 66 40 40 63 7 5 7 7 74 61 61 75 6 7 17 1 47 0 0 0 0 
54 45 1 50 41 41 41 55 42 1 1 1 47 0 0 43 57 1 70 61 75 7 7 7 7 5 7 5 6 7 7 7 7 7 6 7 7 5 7 66 40 40 63 7 7 7 6 5 6 5 6 5 7 17 1 50 55 0 0 0 
43 44 1 49 40 40 40 48 42 1 58 38 53 54 41 45 1 1 14 6 7 33 36 6 5 7 7 6 7 6 5 7 7 7 5 6 7 7 5 74 61 61 75 6 5 7 7 6 5 6 5 7 5 17 1 49 51 41 41 55 
43 44 1 49 40 40 40 51 45 1 50 41 41 46 40 44 1 1 14 7 32 34 37 35 7 5 6 7 6 5 7 5 7 5 7 7 7 5 6 5 6 5 6 5 7 5 7 7 7 5 7 5 7 17 1 49 152 40 40 48 
43 57 1 56 39 39 39 152 44 1 49 40 40 151 40 44 1 1 20 8 21 1 1 14 7 7 7 7 5 7 5 7 5 7 5 7 5 7 7 6 5 6 5 7 5 7 5 7 5 7 7 7 5 17 1 56 152 40 40 48 
42 1 1 1 1 1 1 49 44 1 49 40 40 151 39 57 1 1 1 1 1 1 1 122 112 111 112 111 112 111 112 111 112 111 112 111 112 111 112 111 112 111 112 111 112 111 112 111 112 111 112 111 112 111 1 153 56 39 39 48 
42 1 1 1 58 59 135 56 57 1 56 39 39 57 1 1 1 1 1 1 1 1 1 119 101 102 101 102 101 102 101 102 101 102 101 102 101 102 101 102 101 102 101 102 101 102 101 102 101 102 101 102 101 101 1 1 1 1 129 47 
42 1 58 38 53 42 1 1 1 1 1 1 1 1 1 1 1 1 1 1 1 1 1 119 102 101 102 101 102 101 102 101 102 101 102 101 102 101 102 101 102 101 102 101 102 101 102 101 102 101 102 101 102 101 1 1 1 1 130 47 
42 1 47 0 0 52 38 38 38 38 38 38 38 38 38 59 1 1 1 1 1 1 1 119 101 102 101 102 101 102 101 102 101 102 101 102 101 102 101 102 101 102 101 102 101 102 101 102 101 102 101 102 101 101 1 1 1 1 128 47 
42 1 47 0 0 0 0 0 0 0 0 0 0 0 0 52 38 38 59 1 1 1 1 121 108 107 108 107 108 107 108 107 108 107 108 107 108 107 108 107 108 107 108 107 108 107 108 107 108 107 108 107 107 107 1 1 1 58 38 53 
42 1 50 41 55 0 0 0 0 0 0 0 0 0 0 0 0 0 42 1 1 1 30 28 7 6 7 7 7 7 7 6 5 7 5 6 7 6 5 6 7 7 5 7 5 7 7 7 5 7 5 6 7 24 1 1 58 53 0 0 
42 1 49 40 48 0 0 0 0 0 0 0 0 0 0 0 0 0 62 11 11 11 29 31 6 7 5 7 6 5 6 7 6 5 6 7 6 5 7 7 6 7 7 5 7 7 6 7 7 5 7 7 6 76 38 38 53 0 0 0 
42 1 49 40 48 0 0 0 0 0 0 0 0 0 0 0 0 0 52 77 6 7 5 7 5 6 7 6 7 7 5 6 7 6 7 6 7 7 5 6 7 6 7 7 5 7 7 6 7 7 5 6 5 65 0 0 0 0 0 0 
42 1 56 39 48 0 0 0 0 0 0 0 0 0 0 0 0 0 0 62 5 6 7 7 6 7 6 7 6 5 7 5 7 7 6 7 6 5 7 7 6 7 7 5 7 5 6 7 7 5 7 5 76 53 0 0 0 0 0 0 
42 1 1 154 47 0 0 0 0 0 0 0 0 0 0 0 0 0 0 52 77 7 5 6 7 6 5 6 7 6 7 7 5 7 7 6 7 6 5 7 7 6 5 7 7 6 7 6 5 7 5 76 53 0 0 0 0 0 0 0 
42 1 58 38 53 0 0 0 0 0 0 0 0 0 0 0 0 0 0 0 52 60 77 5 7 5 7 7 6 7 6 5 7 5 6 5 6 5 7 5 6 7 7 7 6 7 6 5 7 5 76 53 0 0 0 0 0 0 0 0 
52 38 53 0 0 0 0 0 0 0 0 0 0 0 0 0 0 0 0 0 0 0 52 60 60 60 60 60 60 60 60 60 60 60 60 60 60 60 60 60 60 60 60 60 60 60 60 60 60 60 53 0 0 0 0 0 0 0 0 0 
