4 7 7 4 4 4 4 4 4 4 4 4 4 4 4 4
4 7 7 7 7 7 7 7 7 7 7 7 7 8 7 4
4 7 7 7 7 7 7 7 7 7 7 7 7 7 7 4
4 7 7 8 7 7 7 7 7 7 7 7 7 7 7 4
4 7 7 7 7 7 7 7 7 7 7 8 7 7 7 4
4 7 7 7 7 7 8 7 7 7 7 7 7 7 7 4
4 7 7 7 7 7 7 7 7 7 7 7 7 7 7 4
4 7 7 7 7 3 2 3 2 3 2 7 7 7 7 4
4 7 7 7 7 2 3 2 3 2 3 7 7 8 7 4
4 8 7 7 7 3 2 3 2 3 2 7 7 7 7 4
4 7 7 7 7 2 3 2 3 2 3 7 7 7 7 4
4 4 4 4 4 4 4 4 4 4 4 4 4 4 4 4