0 0 0 0 0 0 0 0 0 0 0 0 0 0 0 0 0 0 0 0 0 0 0 0 0 0 0 0 0 0 0 0 0 0 0 0 0 0 0 0 0 54 41 41 41 41 41 55 0 0 0 0 0 0 0 0 0 0 0 0 
0 0 0 0 0 0 0 0 0 0 0 0 0 0 0 0 0 0 0 0 0 0 0 0 0 0 0 0 0 0 0 0 0 0 0 0 0 0 0 0 0 43 40 40 40 40 40 48 0 0 0 0 0 0 0 0 0 0 0 0 
0 0 0 0 0 0 0 0 0 0 0 0 0 0 0 0 0 0 0 0 0 0 0 0 0 0 0 0 0 0 0 0 0 0 0 0 0 0 0 0 0 43 40 40 40 40 40 48 0 0 0 0 0 0 0 0 0 0 0 0 
0 0 0 0 0 0 0 0 0 0 0 0 0 0 0 0 0 0 0 0 0 0 0 0 0 0 0 0 0 0 0 0 0 0 0 0 0 0 0 0 0 43 40 40 40 40 40 48 0 0 0 0 0 0 0 0 0 0 0 0 
0 0 0 0 0 0 0 0 0 0 0 0 0 0 0 0 0 0 0 0 0 0 0 0 0 0 0 0 0 0 0 0 0 0 0 0 0 0 0 0 0 62 61 61 61 61 61 65 0 0 0 0 0 0 0 0 0 0 0 0 
0 0 0 0 0 0 0 0 0 0 0 0 0 0 0 0 0 0 0 0 0 0 0 0 0 0 0 0 0 0 0 0 0 0 0 0 0 0 0 0 0 62 5 5 5 5 5 65 0 0 0 0 0 0 0 0 0 0 0 0 
0 0 0 0 0 0 0 0 0 0 0 0 0 0 0 0 0 0 0 0 0 0 0 0 0 0 0 0 0 0 0 0 0 0 0 0 0 0 0 0 54 64 5 5 5 5 5 65 0 0 0 0 0 0 0 0 0 0 0 0 
0 0 0 0 0 0 0 0 0 0 0 0 0 0 0 0 0 0 0 0 54 41 41 55 0 0 0 0 0 0 0 0 0 0 0 0 0 0 0 0 43 63 5 5 5 5 5 65 0 0 0 0 0 0 0 0 0 0 0 0 
0 0 0 0 0 0 0 0 0 0 0 0 0 0 0 0 0 0 0 0 43 40 40 48 0 0 0 0 0 0 0 0 0 0 0 0 0 0 0 0 43 63 5 5 5 5 5 67 41 41 41 41 41 41 41 55 0 0 0 0 
0 0 0 0 0 0 0 0 0 0 0 0 0 0 0 0 0 54 41 41 46 40 40 51 41 41 41 55 0 0 0 0 0 0 0 0 0 0 0 54 46 63 5 5 5 5 5 66 40 40 40 40 40 40 40 51 55 0 0 0 
0 0 0 0 0 0 0 0 0 0 0 0 0 0 0 54 41 46 40 40 151 39 39 152 40 40 152 51 41 55 0 0 0 0 0 0 0 0 0 43 63 75 5 5 5 5 5 66 40 40 40 40 40 40 40 152 48 0 0 0 
0 0 0 0 0 0 0 0 0 0 0 0 0 0 54 46 40 151 40 40 44 124 125 49 40 40 152 152 40 51 55 0 0 0 0 0 0 0 0 43 63 5 5 5 5 5 5 73 73 39 39 39 39 39 39 152 48 0 0 0 
0 0 0 0 0 0 0 0 0 0 0 0 0 54 46 151 40 151 39 39 57 1 1 56 39 39 39 152 40 152 51 55 0 0 0 0 0 0 0 43 63 5 5 5 5 5 5 74 72 1 1 1 1 1 1 56 48 0 0 0 
0 0 0 0 0 0 0 0 0 0 0 0 0 43 151 151 39 57 22 23 1 1 1 1 1 1 1 56 39 152 152 51 55 0 0 0 0 0 0 62 75 5 5 5 5 5 5 5 17 1 1 1 1 1 1 1 47 0 0 0 
0 0 0 0 0 0 0 0 0 0 0 0 54 46 151 57 1 1 20 21 1 1 1 1 1 1 1 1 1 56 152 152 51 55 0 0 0 0 0 62 5 5 5 5 5 5 5 5 17 1 1 1 1 1 1 1 47 0 0 0 
0 0 0 0 0 0 0 0 0 0 0 54 46 151 57 1 1 1 1 1 1 1 1 1 1 1 1 1 1 1 56 152 152 51 41 41 41 41 41 64 5 5 5 5 5 5 33 8 21 1 1 1 1 1 1 1 47 0 0 0 
0 0 0 0 0 0 0 0 0 0 0 43 151 44 1 1 1 1 1 1 1 1 1 1 1 1 1 1 1 1 1 56 152 40 152 40 40 40 40 63 5 5 5 5 5 32 34 1 1 1 1 1 1 1 1 1 47 0 0 0 
0 0 0 0 0 0 0 0 0 0 0 43 151 57 1 1 1 1 1 1 1 1 1 1 1 1 1 1 22 23 1 1 56 39 152 40 40 40 40 63 5 5 5 5 5 17 1 1 1 1 1 1 1 1 1 1 47 0 0 0 
0 0 0 0 0 0 0 0 0 0 0 43 57 1 1 1 1 22 23 1 1 1 1 1 1 1 1 1 20 21 1 1 1 1 56 39 39 39 71 63 5 5 5 5 5 17 1 1 1 1 1 1 1 1 1 1 47 0 0 0 
0 0 0 0 0 0 0 0 0 0 54 45 1 1 1 1 1 20 21 1 1 1 1 1 1 1 1 1 1 1 1 1 1 1 1 1 1 1 70 75 5 5 5 5 5 17 1 1 1 1 1 1 1 1 1 58 53 0 0 0 
0 0 0 0 0 0 0 0 0 0 43 44 1 1 1 1 1 1 1 1 1 1 1 1 1 1 1 1 1 1 1 1 1 1 1 1 1 1 122 111 111 111 111 111 111 111 1 1 1 1 1 1 1 1 1 47 0 0 0 0 
0 0 0 0 0 0 0 0 0 0 43 44 1 1 1 1 1 1 1 1 1 1 1 1 1 1 1 1 1 1 1 1 1 1 1 1 1 1 121 107 107 107 107 107 107 107 1 1 1 1 1 1 1 1 1 47 0 0 0 0 
0 0 0 0 0 0 0 0 0 0 43 57 1 1 1 1 1 1 1 1 1 1 1 1 1 1 1 1 1 1 1 1 1 1 1 1 1 58 77 5 5 5 5 5 5 17 1 1 1 1 1 1 1 1 1 47 0 0 0 0 
0 0 0 0 0 0 0 0 0 0 42 1 1 1 1 1 1 1 1 1 1 1 1 1 1 1 1 1 1 1 1 1 1 1 1 1 58 53 62 5 5 5 5 5 5 17 1 1 1 1 1 1 1 1 1 47 0 0 0 0 
0 0 0 0 0 0 0 0 0 0 42 1 1 1 22 23 1 1 1 1 1 1 1 1 1 1 1 1 1 1 1 1 1 1 1 58 53 0 52 77 5 5 5 5 5 17 1 1 1 1 1 1 1 1 1 47 0 0 0 0 
0 0 0 0 0 0 0 0 0 0 52 59 1 1 20 21 1 1 1 1 1 1 1 1 22 23 1 1 1 1 1 1 1 58 38 53 0 0 0 62 5 5 5 5 5 17 1 1 1 1 1 1 1 1 1 47 0 0 0 0 
0 0 0 0 0 0 0 0 0 0 0 42 1 1 1 1 1 1 1 1 1 1 1 1 20 21 1 1 1 22 23 1 1 47 0 0 0 0 0 62 5 5 5 5 5 17 1 1 1 1 1 1 1 1 1 47 0 0 0 0 
0 0 0 0 0 0 0 0 0 0 0 52 59 1 1 1 1 1 1 1 1 1 1 1 1 1 1 1 1 20 21 1 58 53 0 0 0 0 0 52 77 5 5 5 5 24 26 1 1 1 1 1 1 1 58 53 0 0 0 0 
0 0 0 0 0 0 0 0 0 0 0 0 52 59 1 1 1 1 1 1 1 1 1 1 1 1 1 1 1 58 38 38 53 0 0 0 0 0 0 0 62 5 5 5 5 27 25 23 1 1 1 1 1 1 47 0 0 0 0 0 
0 0 0 0 0 0 0 0 0 0 0 0 0 52 38 38 59 1 1 22 23 1 1 1 1 1 1 58 38 53 0 0 0 0 0 0 0 0 0 0 62 5 5 5 5 5 5 17 1 1 1 1 1 1 47 0 0 0 0 0 
0 0 0 0 0 0 0 0 0 0 0 0 0 0 0 0 52 38 59 20 21 1 1 1 1 1 58 53 0 0 0 0 0 0 0 0 0 0 0 54 64 5 5 5 5 5 5 17 1 1 1 1 1 1 47 0 0 0 0 0 
0 0 0 0 0 0 0 0 0 0 0 0 0 0 0 0 0 0 52 38 38 38 38 38 38 38 53 0 0 0 0 0 0 0 0 0 0 0 0 43 63 5 5 5 5 5 5 17 1 1 1 1 1 1 47 0 0 0 0 0 
0 0 0 0 0 0 0 0 0 0 0 0 0 0 0 0 0 0 0 0 0 0 0 0 0 0 0 0 0 0 0 0 0 0 0 0 0 0 54 46 63 5 5 5 5 5 5 17 1 1 1 1 1 1 47 0 0 0 0 0 
0 0 0 0 0 0 0 0 0 0 0 0 0 0 0 0 0 0 0 0 0 0 0 0 0 0 0 0 0 0 0 0 0 0 0 0 0 54 46 151 63 5 5 27 5 5 33 21 1 1 1 1 1 1 47 0 0 0 0 0 
0 0 0 0 0 0 0 0 0 0 0 0 0 0 0 0 0 0 0 0 0 0 0 0 0 0 0 0 0 0 0 0 0 0 0 0 54 46 151 63 75 5 5 5 5 32 34 1 1 1 1 1 1 1 47 0 0 0 0 0 
0 0 0 0 0 0 0 0 0 0 0 0 0 0 0 0 0 0 0 0 0 0 0 0 0 0 0 0 0 0 0 0 0 0 0 0 43 151 151 63 5 5 5 5 5 17 1 1 1 1 1 1 1 1 47 0 0 0 0 0 
54 41 41 41 41 41 41 41 41 41 41 41 55 0 0 0 0 0 0 0 0 0 0 0 0 0 0 0 0 0 0 0 0 0 0 54 46 151 63 75 5 5 5 5 5 17 1 1 1 1 1 1 1 1 47 0 0 0 0 0 
43 40 40 40 40 40 40 40 40 40 40 40 51 41 41 41 41 41 41 41 41 55 0 0 0 0 0 0 0 0 0 0 0 0 54 46 151 63 75 5 5 5 5 5 5 17 1 1 1 1 1 1 1 1 47 0 0 0 0 0 
43 40 40 40 40 40 40 40 40 40 40 40 152 40 40 40 40 40 40 40 40 51 55 0 0 0 0 0 0 0 0 0 54 41 46 151 63 75 5 5 5 5 5 5 33 21 1 1 1 1 1 1 1 1 47 0 0 0 0 0 
43 40 40 40 40 40 40 40 40 40 40 40 152 40 40 40 40 40 40 40 40 152 51 41 55 0 0 0 0 54 41 41 46 40 151 151 63 5 5 5 5 5 5 32 34 1 1 1 1 1 1 1 1 1 47 0 0 0 0 0 
43 61 61 61 61 61 61 61 61 61 61 61 40 40 40 40 40 40 40 40 40 152 152 40 51 41 41 41 41 46 40 40 151 40 151 63 75 5 5 5 5 5 5 17 1 1 1 1 1 1 1 1 1 58 53 0 0 0 0 0 
62 5 5 5 5 5 5 5 5 5 5 5 74 61 61 61 61 61 61 61 61 66 152 40 152 40 40 40 40 151 40 40 151 40 63 75 5 5 5 5 5 5 5 17 1 1 1 1 1 1 1 1 58 53 0 0 0 0 0 0 
62 5 5 5 5 5 5 5 5 5 5 5 5 5 5 5 5 5 5 5 5 74 66 40 152 40 40 40 40 151 40 40 63 61 75 5 5 5 5 5 5 5 5 17 1 1 1 1 1 1 1 58 53 0 0 0 0 0 0 0 
62 5 5 5 5 5 5 5 5 5 5 5 5 5 5 5 5 5 5 5 5 5 74 61 66 40 40 40 40 63 61 61 75 5 5 5 5 5 5 5 5 5 33 21 1 1 1 1 1 1 1 47 0 0 0 0 0 0 0 0 
52 60 60 60 60 60 60 77 5 5 5 5 5 5 5 5 5 5 5 5 5 5 5 5 74 61 61 61 61 75 5 5 5 5 5 5 5 5 5 5 5 32 34 1 1 1 1 1 1 1 1 47 0 0 0 0 0 0 0 0 
0 0 0 0 0 0 0 52 60 60 60 60 60 60 77 5 5 5 5 5 5 5 5 5 5 5 5 5 5 5 5 5 5 5 5 5 5 5 33 8 8 21 1 1 1 1 1 1 1 1 58 53 0 0 0 0 0 0 0 0 
0 0 0 0 0 0 0 0 0 0 0 0 0 0 52 60 60 77 5 5 5 5 5 5 5 5 5 5 5 5 5 5 5 5 5 5 5 32 34 1 1 1 1 1 1 1 1 1 1 1 47 0 0 0 0 0 0 0 0 0 
0 0 0 0 0 0 0 0 0 0 0 0 54 41 41 41 41 64 8 8 8 36 5 5 5 5 5 5 5 5 5 5 5 33 8 8 8 21 1 1 1 1 1 1 1 1 1 1 1 1 47 0 0 0 0 0 0 0 0 0 
0 0 0 0 0 0 0 0 0 0 0 0 43 40 40 40 40 44 1 1 1 37 35 5 5 5 5 5 5 5 5 5 32 34 1 1 1 1 1 1 1 1 1 1 1 1 1 1 1 1 47 0 0 0 0 0 0 0 0 0 
0 0 0 0 0 0 0 0 0 0 0 0 43 40 40 40 40 44 1 1 1 1 20 8 8 8 8 8 8 8 8 8 21 1 1 1 1 1 1 1 1 1 1 1 1 1 1 1 1 58 53 0 0 0 0 0 0 0 0 0 
0 0 0 0 0 0 0 0 0 0 0 0 43 39 39 39 39 57 1 1 1 1 1 1 1 1 1 1 1 1 1 1 1 1 1 1 1 1 1 1 1 1 1 1 1 1 1 1 1 47 0 0 0 0 0 0 0 0 0 0 
0 0 0 0 0 0 0 0 0 0 0 0 42 129 1 1 1 1 1 1 1 1 1 1 1 1 1 1 1 1 1 1 1 1 1 1 1 1 1 1 1 1 1 1 1 1 1 1 58 53 0 0 0 0 0 0 0 0 0 0 
0 0 0 0 0 0 0 0 0 0 0 0 42 130 1 1 1 1 1 1 1 1 1 1 1 1 1 1 1 1 1 1 1 1 1 1 1 1 1 1 1 1 1 1 1 1 58 38 53 0 0 0 0 0 0 0 0 0 0 0 
0 0 0 0 0 0 0 0 0 0 0 0 42 128 1 1 1 1 1 1 1 1 1 1 1 1 1 1 1 1 1 1 1 1 1 1 1 1 1 1 1 1 1 1 58 38 53 0 0 0 0 0 0 0 0 0 0 0 0 0 
0 0 0 0 0 0 0 0 0 0 0 0 52 38 38 59 1 1 1 1 1 1 1 1 1 1 1 1 1 1 1 1 1 1 1 1 1 1 1 1 1 58 38 38 53 0 0 0 0 0 0 0 0 0 0 0 0 0 0 0 
0 0 0 0 0 0 0 0 0 0 0 0 0 0 0 52 38 38 59 1 1 1 1 1 1 58 38 38 38 38 38 38 38 38 38 38 38 38 38 38 38 53 0 0 0 0 0 0 0 0 0 0 0 0 0 0 0 0 0 0 
0 0 0 0 0 0 0 0 0 0 0 0 0 0 0 0 0 0 52 38 38 38 38 38 38 53 0 0 0 0 0 0 0 0 0 0 0 0 0 0 0 0 0 0 0 0 0 0 0 0 0 0 0 0 0 0 0 0 0 0 
0 0 0 0 0 0 0 0 0 0 0 0 0 0 0 0 0 0 0 0 0 0 0 0 0 0 0 0 0 0 0 0 0 0 0 0 0 0 0 0 0 0 0 0 0 0 0 0 0 0 0 0 0 0 0 0 0 0 0 0 
0 0 0 0 0 0 0 0 0 0 0 0 0 0 0 0 0 0 0 0 0 0 0 0 0 0 0 0 0 0 0 0 0 0 0 0 0 0 0 0 0 0 0 0 0 0 0 0 0 0 0 0 0 0 0 0 0 0 0 0 
0 0 0 0 0 0 0 0 0 0 0 0 0 0 0 0 0 0 0 0 0 0 0 0 0 0 0 0 0 0 0 0 0 0 0 0 0 0 0 0 0 0 0 0 0 0 0 0 0 0 0 0 0 0 0 0 0 0 0 0 
